阿胶	e'jiao
阿魏	a'wei
阿魏化痞膏	a'wei'hua'pi'gao
矮地茶	ai'di'cha
艾附暖宫丸	ai'fu'nuan'gong'wan
艾叶	ai'ye
安宫牛黄散	ang'gong'niu'huang'san
安宫牛黄丸	ang'ong'niu'huang'wan
安坤赞育丸	an'kun'zan'yu'wan
安神补脑液	an'shen'bu'nao'ye
安神补心丸	an'shen'bu'xin'wan
安神胶囊	an'shen'jiao'nang
安胃片	an'wei'pian
安息香	an'xi'xiang
安阳精制膏	an'yang'jing'zhi'gao
安中片	an'zhong'pian
八宝坤顺丸	ba'bao'kun'shun'wan
八角茴香	ba'jiao'hui'xiang
八角茴香油	ba'jiao'hui'xiang'you
八味沉香散	ba'wei'chen'xiang'san
八味清心沉香散	ba'wei'qing'xin'chen'xiang'san
八味檀香散	ba'wei'tan'xiang'san
八珍丸	ba'zhen'wan
八珍益母丸	ba'zhen'wan
八正合剂	ba'zheng'he'ji
巴豆	ba'dou
巴豆霜	ba'dou'shuang
巴戟天	ba'ji'tian
白扁豆	bai'bian'dou
白带丸	bai'dai'wan
白矾	bai'fan
白附子	bai'fu'zi
白果	bai'guo
白及	bai'ji
白茅根	bai'mao'gen
白前	bai'qian
白芍	bai'shao
白术	bai'zhu
白头翁	bai'tou'weng
白鲜皮	bai'xian'pi
白芷	bai'zhi
白蔹	bai'lian
白薇	bai'wei
柏子仁	bai'zi'ren
柏子养心丸	bai'zi'yang'xin'wan
百部	bai'bu
百合	bai'he
百合固金丸	bai'he'gu'jin'wan
浓缩丸	nong'suo'wan
百令胶囊	bai'ling'jiao'nang
斑蝥	ban'mao
板蓝根	ban'lang'en
板蓝根颗粒	ban'lang'en'ke'li
半边莲	ban'bian'lian
半夏	ban'xia
半枝莲	ban'zhi'lian
薄荷	bo'he
薄荷脑	bo'hen'ao
薄荷素油	bo'he'su'you
薄荷油	bo'he'you
保赤散	bao'chi'san
保妇康栓	bao'fu'kang'shuan
保和丸	bao'he'wan
水丸	shui'wan
保济丸	bao'ji'wan
宝咳宁颗粒	bao'ke'ning'ke'li
抱龙丸	bao'long'wan
北豆根	bei'dou'gen
北豆根片	bei'dou'gen'pian
北沙参	bei'sha'shen
贝羚胶囊	bei'ling'jiao'nang
鼻炎片	bi'yan'pian
鼻渊舒口服液	bi'yuan'shu'kou'fu'ye
鼻窦炎口服液	bi'dou'yan'kou'fu'ye
蓖麻油	bi'ma'you
蓖麻子	bi'ma'zi
避瘟散	bi'wen'san
扁蓄	bian'xu
鳖甲	bie'jia
冰硼散	bing'peng'san
冰片	bing'pian
合成龙脑	he'cheng'long'nao
拨云退翳丸	bo'yun'tui'yi'wan
补骨脂	bu'gu'zhi
补肾固齿丸	bu'shen'gu'chi'wan
补肾益脑片	bu'shen'yin'ao'pian
补中益气丸	bu'zhong'yi'qi'wan
参精止渴丸	shen'jing'zhi'ke'wan
降糖丸	jiang'tang'wan
参茸白凤丸	shen'rong'bai'feng'wan
参茸保胎丸	shen'rong'bao'tai'wan
参茸固本片	shen'rong'gu'ben'pian
参苏丸	shen'su'wan
参芪五味子片	shen'qi'wu'wei'zi'pian
参苓白术散	shen'ling'bai'zhu'san
蚕蛾公补片	can'e'gong'bu'pian
苍耳子	cang'er'zi
苍术	cang'zhu
草豆蔻	cao'dou'kou
草果	cao'guo
草乌	cao'wu
草乌叶	cao'wu'ye
侧柏叶	ce'bai'ye
茶油	cha'you
柴胡	chai'hu
柴胡口服液	chai'hu'kou'fu'ye
柴胡舒肝丸	chai'hu'shu'gan'wan
蝉蜕	chan'tui
产复康颗粒	chan'fu'kang'ke'li
常山	chang'shan
肠胃宁片	chang'wei'ning'pian
炒瓜蒌子	chao'gua'lou'zi
车前草	che'qian'cao
车前子	che'qian'zi
沉香	chen'xiang
沉香化气丸	chen'xiang'hua'qi'wan
陈皮	chen'pi
陈皮	chen'pi
赤芍	chi'shao
赤石脂	chi'shi'zhi
赤小豆	chi'xiao'dou
虫白蜡	chong'bai'la
川贝母	chuan'bei'mu
川贝雪梨膏	chuan'bei'xue'li'gao
川贝枇杷糖浆	chuan'bei'pi'pa'tang'jiang
川木通	chuan'mu'tong
川木香	chuan'mu'xiang
川牛膝	chuan'niu'xi
川射干	chuan'she'gan
川乌	chuan'wu
川芎	chuan'xiong
川芎茶调散	chuan'xiong'cha'tiao'san
川芎茶调丸	chuan'xiong'cha'tiao'wan
川楝子	chuan'lian'zi
穿山甲	chuan'shan'jia
穿山龙	chuan'shan'long
穿心莲	chuan'xin'lian
穿心莲片	chuan'xin'lian'pian
垂盆草	chui'pen'cao
椿皮	chun'pi
纯阳正气丸	chun'yang'zheng'qi'wan
磁石	ci'shi
刺五加	ci'wu'jia
刺五加浸膏	ci'wu'jia'jing'ao
刺五加片	ci'wu'jia'pian
催汤丸	cui'tang'wan
大补阴丸	da'bu'yin'wan
大腹皮	da'fu'pi
大黄	da'huang
大黄蟅虫丸	da'huang'zhe'chong'wan
大黄流浸膏	da'huang'liu'jing'gao
大黄清胃丸	da'huang'qing'wei'wan
大蓟	da'ji
大蓟炭	da'ji'tan
大青叶	da'qing'ye
大山楂丸	da'shan'zha'wan
大血藤	da'xue'teng
大枣	da'zao
代温灸膏	dai'wen'jiu'gao
丹参	dan'shen
丹参片	dan'shen'pian
胆固醇	dan'gu'chun
胆红素	dan'hong'su
胆乐胶囊	dan'le'jiao'nang
胆南星	dan'nan'xing
胆宁片	dan'ning'pian
淡豆豉	dan'dou'chi
淡竹叶	dan'zhu'ye
当归	dang'gui
当归流浸膏	dang'gui'liu'jing'ao
当归龙荟丸	dang'gui'long'hui'wan
当归养血丸	dang'gui'yang'xue'wan
党参	dang'shen
刀豆	dao'dou
导赤丸	dao'chi'wan
稻芽	dao'ya
稻芽	dao'ya
灯心草	deng'xin'cao
灯盏细辛	deng'zhan'xi'xin
灯盏花	deng'zhan'hua
灯盏细辛注射液	deng'zhan'xi'xin'zhu'she'ye
地奥心血康	di'ao'xin'xue'kang
地奥心血康胶囊	di'ao'xin'xue'kang'jiao'nang
地枫皮	di'feng'pi
地肤子	di'fu'zi
地骨皮	di'gu'pi
地黄	di'huang
地锦草	di'jin'cao
地龙	di'long
地榆	di'yu
颠茄草	dian'qie'cao
颠茄浸膏	dian'qie'jing'ao
颠茄流浸膏	dian'qie'liu'jing'ao
颠茄片	dian'qie'pian
颠茄酊	dian'qie'ding
调经促孕丸	tiao'jing'cu'yun'wan
跌打活血散	die'da'huo'xue'san
跌打丸	die'da'wan
跌打镇痛膏	die'da'zhen'tong'gao
丁公藤	ding'gong'teng
丁香	ding'xiang
丁香罗勒油	ding'xiang'luo'le'you
定坤丹	ding'kun'dan
冬虫夏草	dong'chong'xia'cao
冬瓜皮	dong'gua'pi
冬葵果	dong'kui'guo
豆蔻	dou'kou
独活	du'huo
独一味	du'yi'wei
独一味胶囊	du'yi'wei'jiao'nang
杜仲	du'zhong
杜仲叶	du'zhong'ye
断血流	duan'xue'liu
断血流颗粒	duan'xue'liu'ke'li
断血流片	duan'xue'liu'pian
鹅不食草	e'bu'shi'cao
儿茶	er'cha
儿童清肺丸	er'tong'qing'fei'wan
耳聋左慈丸	er'long'zuo'ci'wan
二陈丸	er'chen'wan
二丁颗粒	er'ding'ke'li
二冬膏	er'dong'gao
二妙丸	er'miao'wan
二十五味珊瑚丸	er'shi'wu'wei'shan'hu'wan
二十五味松石丸	er'shi'wu'wei'song'shi'wan
二十五味珍珠丸	er'shi'wu'wei'zhen'zhu'wan
二至丸	er'zhi'wan
法半夏	fa'ban'xia
番泻叶	fan'xie'ye
防风	fang'feng
防风通圣丸	fang'feng'tong'sheng'wan
防己	fang'ji
肥儿丸	fei'er'wan
分清五淋丸	fen'qing'wu'lin'wan
粉葛	feng'e
粉萆薢	fen'bi'xie
枫香脂	feng'xiang'zhi
蜂房	feng'fang
蜂胶	feng'jiao
蜂蜡	feng'la
蜂蜜	feng'mi
风寒咳嗽颗粒	feng'han'ke'sou'ke'li
风湿骨痛胶囊	feng'shi'gu'tong'jiao'nang
风湿马钱片	feng'shi'ma'qian'pian
冯了性风湿跌打药酒	feng'liao'xing'feng'shi'die'da'yao'jiu
佛手	fo'shou
浮萍	fu'ping
覆盆子	fu'pen'zi
复方川贝精片	fu'fang'chuan'bei'jing'pian
复方醋酸地塞米松乳膏	fu'fang'cu'suan'di'sai'mi'song'ru'gao
复方丹参滴丸	fu'fang'dan'shen'di'wan
复方丹参片	fu'fang'dan'shen'pian
复方扶芳藤合剂	fu'fang'fu'fang'teng'he'ji
复方瓜子金颗粒	fu'fang'gua'zi'jin'ke'li
复方黄连素片	fu'fang'huang'lian'su'pian
复方鸡血藤膏	fu'fang'ji'xue'teng'gao
复方牵正膏	fu'fang'qian'zheng'gao
复方仙鹤草肠炎胶囊	fu'fang'xian'he'cao'chang'yan'jiao'nang
复方鲜竹沥液	fu'fang'xian'zhu'li'ye
复方皂矾丸	fu'fang'zao'fan'wan
复合胆红素钙	fu'he'dan'hong'su'gai
附子	fu'zi
附子理中丸	fu'zi'li'zhong'wan
妇宝颗粒	fu'bao'ke'li
妇科调经片	fu'ke'tiao'jing'pian
妇科分清丸	fu'ke'fen'qing'wan
妇科千金片	fu'ke'qian'jin'pian
妇科十味片	fu'ke'shi'wei'pian
妇科通经丸	fu'ke'tong'jing'wan
妇炎净胶囊	fu'yan'jing'jiao'nang
干漆	gan'qi
甘草	gan'cao
甘草浸膏	gan'cao'jing'ao
甘草流浸膏	gan'cao'liu'jing'ao
甘松	gan'song
甘遂	gan'sui
感冒清热颗粒	gan'mao'qing're'ke'li
感冒舒颗粒	gan'mao'shu'ke'li
感冒退热颗粒	gan'mao'tui're'ke'li
高良姜	gao'liang'jiang
葛根	ge'gen
葛根芩连片	ge'gen'qin'lian'pian
葛根芩连丸	ge'gen'qin'lian'wan
葛根芩连微丸	ge'gen'qin'lian'wei'wan
蛤壳	ge'ke
蛤蚧	ge'jie
蛤蚧定喘丸	ge'jie'ding'chuan'wan
根痛平颗粒	gen'tong'ping'ke'li
更年安片	geng'nian'an'pian
功劳木	gong'lao'mu
功劳去火片	gong'lao'qu'huo'pian
宫血宁胶囊	gong'xue'ning'jiao'nang
钩藤	gou'teng
狗脊	gou'ji
狗皮膏	gou'pi'gao
骨刺消痛片	gu'ci'xiao'tong'pian
骨碎补	gu'sui'bu
谷精草	gu'jing'cao
谷芽	gu'ya
固本咳喘片	gu'ben'ke'chuan'pian
固经丸	gu'jing'wan
瓜蒌	gua'lou
瓜蒌皮	gua'lou'pi
瓜蒌子	gua'lou'zi
关黄柏	guan'huang'bo
冠心丹参胶囊	guan'xin'dan'shen'jiao'nang
冠心丹参片	guan'xin'dan'shen'pian
冠心苏合丸	guan'xin'su'he'wan
贯叶金丝桃	guan'ye'jin'si'tao
广金钱草	guang'jin'qian'cao
广枣	guang'zao
广藿香	guang'huo'xiang
广藿香油	guang'huo'xiang'you
归脾丸	gui'pi'wan
归芍地黄丸	gui'shao'di'huang'wan
龟甲	gui'jia
龟甲胶	gui'jia'jiao
龟龄集	gui'ling'ji
龟鹿补肾丸	gui'lu'bu'shen'wan
桂附地黄丸	gui'fu'di'huang'wan
桂附理中丸	gui'fu'li'zhong'wan
桂林西瓜霜	gui'lin'xi'gua'shuang
桂龙咳喘宁胶囊	gui'long'ke'chuan'ning'jiao'nang
桂枝	gui'zhi
桂枝茯苓胶囊	gui'zhi'fu'ling'jiao'nang
桂枝茯苓丸	gui'zhi'fu'ling'wan
国公酒	guo'gong'jiu
哈蟆油	ha'ma'you
海风藤	hai'feng'teng
海金沙	hai'jin'sha
海龙	hai'long
海马	hai'ma
海藻	hai'zao
海螵蛸	hai'piao'xiao
荷丹片	he'dan'pian
荷叶	he'ye
荷叶丸	he'ye'wan
核桃仁	he'tao'ren
何首乌	he'shou'wu
合欢花	he'huan'hua
合欢皮	he'huan'pi
河车大造丸	he'che'da'zao'wan
鹤虱	he'shi
黑芝麻	hei'zhi'ma
黑种草子	hei'zhong'cao'zi
红参	hong'shen
红大戟	hong'da'ji
红豆蔻	hong'dou'kou
红粉	hong'fen
红花	hong'hua
红景天	hong'jing'tian
红灵散	hong'ling'san
红药贴膏	hong'yao'tie'gao
红芪	hong'qi
猴头健胃灵胶囊	hou'tou'jian'wei'ling'jiao'nang
厚朴	hou'po
厚朴花	hou'po'hua
胡蜂酒	hu'feng'jiu
胡黄连	hu'huang'lian
胡椒	hu'jiao
胡芦巴	hu'lu'ba
湖北贝母	hu'bei'bei'mu
虎杖	hu'zhang
护肝片	hu'gan'pian
花椒	hua'jiao
花蕊石	hua'rui'shi
华山参	hua'shan'shen
华山参片	hua'shan'shen'pian
华佗再造丸	hua'tuo'zai'zao'wan
滑石	hua'shi
滑石粉	hua'shi'fen
化症回生片	hua'zheng'hui'sheng'pian
化积口服液	hua'ji'kou'fu'ye
化痔栓	hua'zhi'shuan
化橘红	hua'ju'hong
槐花	huai'hua
槐角	huai'jiao
槐角丸	huai'jiao'wan
环维黄杨星D	huan'wei'huang'yang'xing'd
黄柏	huang'bo
黄精	huang'jing
黄连	huang'lian
黄连上清丸	huang'lian'shang'qing'wan
黄连羊肝丸	huang'lian'yang'gan'wan
黄氏响声丸	huang'shi'xiang'sheng'wan
黄藤	huang'teng
黄杨宁片	huang'yang'ning'pian
黄芩	huang'qin
黄芩提取物	huang'qin'ti'qu'wu
黄芪	huang'qi
活血止痛散	huo'xue'zhi'tong'san
火麻仁	huo'ma'ren
积雪草	ji'xue'cao
鸡骨草	ji'gu'cao
鸡冠花	ji'guan'hua
鸡内金	jin'ei'jin
鸡血藤	ji'xue'teng
急性子	ji'xing'zi
急支糖浆	ji'zhi'tang'jiang
济生肾气丸	ji'sheng'shen'qi'wan
加味生化颗粒	jia'wei'sheng'hua'ke'li
加味逍遥丸	jia'wei'xiao'yao'wan
鳖甲	bie'jia
健步丸	jian'bu'wan
健民咽喉片	jian'min'yan'hou'pian
健脾丸	jian'pi'wan
僵蚕	jiang'can
姜黄	jiang'huang
姜流浸膏	jiang'liu'jing'gao
姜酊	jiang'ding
降香	jiang'xiang
焦槟榔	jiao'bing'lang
桔梗	jie'geng
洁白丸	jie'bai'wan
解肌宁嗽丸	jie'ji'ning'sou'wan
芥子	jie'zi
金沸草	jin'fei'cao
金果含片	jin'guo'han'pian
金果榄	jin'guo'lan
金蒲胶囊	jin'pu'jiao'nang
金钱白花蛇	jin'qian'bai'hua'she
金钱草	jin'qian'cao
金嗓利咽丸	jin'sang'li'yan'wan
金嗓散结丸	jin'sang'san'jie'wan
金水宝片	jin'shui'bao'pian
金银花	jin'yin'hua
金樱子	jin'ying'zi
金荞麦	jin'qiao'mai
金礞石	jin'meng'shi
锦灯笼	jin'deng'long
荆芥	jing'jie
荆芥穗	jing'jie'sui
荆芥穗炭	jing'jie'sui'tan
荆芥炭	jing'jie'tan
京大戟	jing'da'ji
精制冠心颗粒	jing'zhi'guan'xin'ke'li
精制冠心片	jing'zhi'guan'xin'pian
颈复康颗粒	jing'fu'kang'ke'li
韭菜子	jiu'cai'zi
九分散	jiu'fen'san
九里香	jiu'li'xiang
九气拈痛丸	jiu'qi'nian'tong'wan
九圣散	jiu'sheng'san
九味羌活颗粒	jiu'wei'qiang'huo'ke'li
九味羌活口服液	jiu'wei'qiang'huo'kou'fu'ye
九味羌活丸	jiu'wei'qiang'huo'wan
九味石灰华散	jiu'wei'shi'hui'hua'san
九香虫	jiu'xiang'chong
九一散	jiu'yi'san
菊花	ju'hua
菊苣	ju'ju
局方至宝散	ju'fang'zhi'bao'san
卷柏	juan'bai
决明子	jue'ming'zi
开胸顺气丸	kai'xiong'shun'qi'wan
坎离砂	kan'li'sha
抗感颗粒	kang'gan'ke'li
抗骨增生胶囊	kang'gu'zeng'sheng'jiao'nang
抗骨增生胶囊	kang'gu'zeng'sheng'jiao'nang
抗骨增生丸	kang'gu'zeng'sheng'wan
克伤痛搽剂	ke'shang'tong'cha'ji
控涎丸	kong'xian'wan
口炎清颗粒	kou'yan'qing'ke'li
苦参	ku'shen
苦地丁	ku'di'ding
苦木	ku'mu
苦杏仁	ku'xing'ren
苦楝皮	ku'lian'pi
款冬花	kuan'dong'hua
昆布	kun'bu
昆明山海棠片	kun'ming'shan'hai'tang'pian
莱菔子	lai'fu'zi
狼疮丸	lang'chuang'wan
老鹳草	lao'guan'cao
老鹳草软膏	lao'guan'cao'ruan'gao
乐脉颗粒	le'mai'ke'li
雷丸	lei'wan
荔枝核	li'zhi'he
利胆排石片	li'dan'pai'shi'pian
利咽解毒颗粒	li'yan'jie'du'ke'li
莲房	lian'fang
莲须	lian'xu
莲子	lian'zi
莲子心	lian'zi'xin
连钱草	lian'qian'cao
连翘	lian'qiao
连翘提取物	lian'qiao'ti'qu'wu
良附丸	liang'fu'wan
两面针	liang'mian'zhen
两头尖	liang'tou'jian
羚羊感冒片	ling'yang'gan'mao'pian
羚羊角	ling'yang'jiao
羚羊角胶囊	ling'yang'jiao'jiao'nang
羚羊清肺丸	ling'yang'qing'fei'wan
凌霄花	ling'xiao'hua
灵宝护心丹	ling'bao'hu'xin'dan
灵芝	ling'zhi
硫黄	liu'huang
六合定中丸	liu'he'ding'zhong'wan
六味安消散	liu'wei'an'xiao'san
六味地黄丸	liu'wei'di'huang'wan
六味木香散	liu'wei'mu'xiang'san
六一散	liu'yi'san
六应丸	lu'ying'wan
龙胆	long'dan
龙胆泻肝丸	long'dan'xie'gan'wan
大蜜丸	da'mi'wan
龙胆泻肝丸	long'dan'xie'gan'wan
龙牡壮骨颗粒	long'mu'zhuang'gu'ke'li
龙眼肉	long'yan'rou
漏芦	lou'lu
芦根	lu'gen
芦荟	lu'hui
炉甘石	lu'gan'shi
路路通	lu'lu'tong
鹿角	lu'jiao
鹿角胶	lu'jiao'jiao
鹿角霜	lu'jiao'shuang
鹿茸	lu'rong
鹿茸	lu'rong
鹿角胶	lu'jiao'jiao
鹿角	lu'jiao
鹿角霜	lu'jiao'shuang
鹿衔草	lu'xian'cao
罗布麻叶	luo'bu'ma'ye
罗汉果	luo'han'guo
络石藤	luo'shi'teng
麻黄	ma'huang
麻黄根	ma'huang'gen
麻仁润肠丸	ma'ren'run'chang'wan
麻仁丸	ma'ren'wan
麻油	ma'you
马鞭草	ma'bian'cao
马勃	ma'bo
马齿苋	ma'chi'xian
马兜铃	ma'dou'ling
马钱子	ma'qian'zi
马钱子粉	ma'qian'zi'fen
马钱子散	ma'qian'zi'san
马应龙麝香痔疮膏	ma'ying'long'she'xiang'zhi'chuang'gao
麦冬	mai'dong
麦味地黄丸	mai'wei'di'huang'wan
麦芽	mai'ya
稻芽	dao'ya
满山红	man'shan'hong
满山红油	man'shan'hong'you
满山红油胶丸	man'shan'hong'you'jiao'wan
蔓荆子	man'jing'zi
芒硝	mang'xiao
猫爪草	mao'zhao'cao
毛诃子	mao'he'zi
玫瑰花	mei'gui'hua
梅花	mei'hua
梅花点舌丸	mei'hua'dian'she'wan
密蒙花	mi'meng'hua
绵马贯众	mian'ma'guan'zhong
绵马贯众炭	mian'ma'guan'zhong'tan
绵萆解	mian'bi'xie
妙济丸	miao'ji'wan
明党参	ming'dang'shen
明目地黄丸	ming'mu'di'huang'wan
墨旱莲	mo'han'lian
牡丹皮	mu'dan'pi
牡荆叶	mu'jing'ye
牡荆油	mu'jing'you
牡荆油胶丸	mu'jing'you'jiao'wan
牡蛎	mu'li
母丁香	mu'ding'xiang
木鳖子	mu'bie'zi
木瓜	mu'gua
木瓜丸	mu'gua'wan
木蝴蝶	mu'hu'die
木通	mu'tong
木香	mu'xiang
木香分气丸	mu'xiang'fen'qi'wan
木香槟榔丸	mu'xiang'bing'lang'wan
木贼	mu'zei
南板蓝根	nan'ban'lang'en
南鹤虱	nan'he'shi
南沙参	nan'sha'shen
脑得生片	nao'de'sheng'pian
脑得生丸	nao'de'sheng'wan
脑乐静	nao'le'jing
脑立清丸	nao'li'qing'wan
闹羊花	nao'yang'hua
牛胆粉	niu'dan'fen
牛黄	niu'huang
牛黄抱龙丸	niu'huang'bao'long'wan
牛黄降压胶囊	niu'huang'jiang'ya'jiao'nang
牛黄降压丸	niu'huang'jiang'ya'wan
牛黄解毒片	niu'huang'jie'du'pian
牛黄解毒丸	niu'huang'jie'du'wan
牛黄千金散	niu'huang'qian'jin'san
牛黄清心丸	niu'huang'qing'xin'wan
局方	ju'fang
牛黄上清胶囊	niu'huang'shang'qing'jiao'nang
牛黄上清丸	niu'huang'shang'qing'wan
牛黄消炎片	niu'huang'xiao'yan'pian
牛黄镇惊丸	niu'huang'zhen'jing'wan
牛黄至宝丸	niu'huang'zhi'bao'wan
牛膝	niu'xi
牛蒡子	niu'bang'zi
女金丸	nu'jin'wa
女贞子	nv'zhen'zi
暖脐膏	nuan'qi'gao
藕节	ou'jie
排石颗粒	pai'shi'ke'li
胖大海	pang'da'hai
炮姜	pao'jiang
佩兰	pei'lan
片姜黄	pian'jiang'huang
平贝母	ping'bei'mu
平肝舒络丸	ping'gan'shu'luo'wan
蒲公英	pu'gong'ying
蒲黄	pu'huang
七宝美髯颗粒	qi'bao'mei'ran'ke'li
七厘散	qi'li'san
七十味珍味丸	qi'shi'wei'zhen'zhu'wan
七味榼藤子丸	qi'wei'ke'teng'zi'wan
七味都气丸	qi'wei'du'qi'wan
七味广枣丸	qi'wei'guang'zao'wan
七味葡萄散	qi'wei'pu'tao'san
七味铁屑丸	qi'wei'tie'xie'wan
七叶神安片	qi'ye'shen'an'pian
七珍丸	qi'zhen'wan
启脾丸	qi'pi'wan
牵牛子	qian'niu'zi
千柏鼻炎片	qian'bai'bi'yan'pian
千金止带丸	qian'jin'zhi'dai'wan
千金子	qian'jin'zi
千金子霜	qian'jin'zi'shuang
千年健	qian'nian'jian
前胡	qian'hu
前列舒丸	qian'lie'shu'wan
羌活	qiang'huo
强阳保肾丸	qiang'yang'bao'shen'wan
秦皮	qin'pi
秦艽	qin'jiao
青娥丸	qing'e'wan
青风藤	qing'feng'teng
青果	qing'guo
青果丸	qing'guo'wan
青皮	qing'pi
青叶胆	qing'ye'dan
青叶胆片	qing'ye'dan'pian
青葙子	qing'xiang'zi
青蒿	qing'hao
青礞石	qing'meng'shi
青黛	qing'dai
轻粉	qing'fen
清肺消炎丸	qing'fei'xiao'yan'wan
清肺抑火丸	qing'fei'yi'huo'wan
清喉利咽颗粒	qing'hou'li'yan'ke'li
清喉咽合剂	qing'hou'yan'he'ji
清火栀麦片	qing'huo'zhi'mai'pian
清开灵口服液	qing'kai'ling'kou'fu'ye
清开灵注射液	qing'kai'ling'zhu'she'ye
清淋颗粒	qing'lin'ke'li
清脑降压片	qing'nao'jiang'ya'pian
清宁丸	qing'ning'wan
清气化痰丸	qing'qi'hua'tan'wan
清热解毒口服液	qing're'jie'du'kou'fu'ye
清胃黄连丸	qing'wei'huang'lian'wan
清瘟解毒丸	qing'wen'jie'du'wan
清眩丸	qing'xuan'wan
清咽丸	qing'yan'wan
清音丸	qing'yin'wan
去氧胆酸	qu'yang'dan'suan
全天麻胶囊	quan'tian'ma'jiao'nang
全蝎	quan'xie
拳参	quan'shen
热炎宁颗粒	re'yan'ning'ke'li
仁青常觉	ren'qing'chang'jue
仁青芒觉	ren'qing'mang'jue
人参	ren'shen
人参健脾丸	ren'shen'jian'pi'wan
人参养荣丸	ren'shen'yang'rong'wan
人参叶	ren'shen'ye
人参再造丸	ren'shen'zai'zao'wan
人工牛黄	reng'ong'niu'huang
忍冬藤	ren'dong'teng
肉豆蔻	rou'dou'kou
肉桂	rou'gui
肉桂油	rou'gui'you
肉苁蓉	rou'cong'rong
如意金黄散	ru'yi'jin'huang'san
乳疾灵颗粒	ru'ji'ling'ke'li
乳块消片	ru'kuai'xiao'pian
乳癖消片	ru'pi'xiao'pian
三白草	san'bai'cao
三宝胶囊	san'bao'jiao'nang
三黄片	san'huang'pian
三金片	san'jin'pian
三棱	san'leng
三两半药酒	san'liang'ban'yao'jiu
三妙丸	san'miao'wan
三七	san'qi
三七片	san'qi'pian
三七伤药片	san'qi'shang'yao'pian
三七叶总皂苷	san'qi'ye'zong'zao'gan
三味蒺藜散	san'wei'ji'li'san
三子散	san'zi'san
桑白皮	sang'bai'pi
桑寄生	sang'ji'sheng
桑菊感冒片	sang'ju'gan'mao'pian
桑叶	sang'ye
桑枝	sang'zhi
桑椹	sang'shen
桑螵蛸	sang'piao'xiao
砂仁	sha'ren
沙棘	sha'ji
沙苑子	sha'yuan'zi
山慈菇	shan'ci'gu
山豆根	shan'dou'gen
山菊降压片	shan'ju'jiang'ya'pian
山楂降压片	shan'zha'jiang'ya'pian
山麦冬	shan'mai'dong
山药	shan'yao
山银花	shan'yin'hua
山茱萸	shan'zhu'yu
山柰	shan'nai
山楂	shan'zha
山楂化滞丸	shan'zha'hua'zhi'wan
山楂叶	shan'zha'ye
山楂叶提取物	san'zha'ye'ti'qu'wu
伤湿止痛膏	shan'shi'zhi'tong'gao
伤痛宁片	shang'tong'ning'pian
商陆	shang'lu
烧伤灵酊	shao'shang'ling'ding
少腹逐瘀丸	shao'fu'zhu'yu'wan
少林风湿跌打膏	shao'lin'feng'shi'die'da'gao
蛇床子	she'chuang'zi
蛇胆陈皮散	she'dan'chen'pi'san
蛇胆川贝散	she'dan'chuan'bei'san
蛇蜕	she'tui
射干	she'gan
伸筋草	shen'jin'cao
生姜	sheng'jiang
生脉饮	sheng'mai'yin
生血丸	sheng'xue'wan
升麻	sheng'ma
十滴水	shi'di'shui
十滴水软胶囊	shi'di'shui'ruan'jiao'nang
十二味翼首散	shi'er'wei'yi'shou'san
十六味冬青丸	shi'liu'wei'dong'qing'wan
十全大补丸	shi'quan'da'bu'wan
十三味榜嘎散	shi'san'wei'bang'ga'san
十五味沉香丸	shi'wu'wei'chen'xiang'wan
十香返生丸	shi'xiang'fan'sheng'wan
十香止痛丸	shi'xiang'zhi'tong'wan
十一味能消丸	shi'yi'wei'neng'xiao'wan
石膏	shi'gao
石决明	shi'jue'ming
石淋通片	shi'lin'tong'pian
石榴皮	shi'liu'pi
石韦	shi'wei
石菖蒲	shi'chang'pu
石斛	shi'hu
石斛夜光丸	shi'hu'ye'guang'wan
使君子	shi'jun'zi
柿蒂	shi'di
首乌藤	shou'wu'teng
首乌丸	shou'wu'wan
舒肝和胃丸	shu'gan'he'wei'wan
舒肝丸	shu'gan'wan
舒筋活络酒	shu'jin'huo'luo'jiu
舒筋丸	shu'jin'wan
舒心口服液	shu'xin'kou'fu'ye
舒胸片	shu'xiong'pian
疏风定痛丸	shu'feng'ding'tong'wan
熟地黄	shu'di'huang
暑症片	shu'zheng'pian
双黄连颗粒	shuang'huang'lian'ke'li
双黄连口服液	shuang'huang'lian'kou'fu'ye
双黄连片	shuang'huang'lian'pian
双黄连栓	shuang'huang'lian'shuan
小儿消炎栓	xiao'er'xiao'yan'shuan
水飞蓟	shui'fei'ji
水红花子	shui'hong'hua'zi
水牛角	shui'niu'jiao
水牛角浓缩粉	shui'niu'jiao'nong'suo'fen
水蛭	shui'zhi
丝瓜络	si'gua'luo
四君子丸	si'jun'zi'wan
四逆汤	si'ni'tang
四神丸	si'shen'wan
四味土木香散	si'wei'tu'mu'xiang'san
四味珍层冰硼滴眼液	si'wei'zhen'ceng'bing'peng'di'yan'ye
珍视明滴眼液	zhen'shi'ming'di'yan'ye
四物合剂	si'wu'he'ji
四正丸	si'zheng'wan
松花粉	song'hua'fen
松节油	song'jie'you
松龄血脉康胶囊	song'ling'xue'mai'kang'jiao'nang
苏合香	su'he'xiang
苏合香丸	su'he'xiang'wan
苏木	su'mu
酸枣仁	suan'zao'ren
锁阳	suo'yang
锁阳固精丸	suo'yang'gu'jing'wan
太子参	tai'zi'shen
檀香	tan'xiang
桃仁	tao'ren
体外培育牛黄	ti'wai'pei'yu'niu'huang
天冬	tian'dong
天花粉	tian'hua'fen
天葵子	tian'kui'zi
天麻	tian'ma
天麻首乌片	tian'ma'shou'wu'pian
天麻丸	tian'ma'wan
天南星	tian'nan'xing
天然冰片	tian'ran'bing'pian
右旋龙脑	you'xuan'long'nao
天山雪莲	tian'shan'xue'lian
天王补心丸	tian'wang'bu'xin'wan
天仙藤	tian'xian'teng
天仙子	tian'xian'zi
天竺黄	tian'zhu'huang
通草	tong'cao
通关散	tong'guan'san
通窍鼻炎片	tong'qiao'bi'yan'pian
通天口服液	tong'tian'kou'fu'ye
通心络胶囊	tong'xin'luo'jiao'nang
通宣理肺丸	tong'xuan'li'fei'wan
痛经宝颗粒	tong'jing'bao'ke'li
痛经丸	tong'jing'wan
土贝母	tu'bei'mu
土荆皮	tu'jing'pi
土木香	tu'mu'xiang
土茯苓	tu'fu'ling
瓦楞子	wa'leng'zi
瓦松	wa'song
万氏牛黄清心丸	wan'shi'niu'huang'qing'xin'wan
万通炎康片	wan'tong'yan'kang'pian
万应锭	wan'ying'ding
万应胶囊	wan'ying'jiao'nang
王不留行	wang'bu'liu'xing
威灵仙	wei'ling'xian
委陵菜	wei'ling'cai
胃肠安丸	wei'chang'an'wan
胃康灵胶囊	wei'kang'ling'jiao'nang
胃舒宁颗粒	wei'shu'ning'ke'li
乌贝散	wu'bei'san
乌鸡白凤丸	wu'ji'bai'feng'wan
乌灵胶囊	wu'ling'jiao'nang
乌灵菌粉	wu'ling'jun'fen
乌梅	wu'mei
乌梢蛇	wu'shao'she
乌药	wu'yao
吴茱萸	wu'zhu'yu
五倍子	wu'bei'zi
五福化毒丸	wu'fu'hua'du'wan
五虎散	wu'hu'san
五加皮	wu'jia'pi
五味清浊散	wu'wei'qing'zhuo'san
五味沙棘散	wu'wei'sha'ji'san
五味子	wu'wei'zi
五味麝香丸	wu'wei'she'xiang'wan
五子衍宗丸	wu'zi'yan'zong'wan
五苓散	wu'ling'san
午时茶颗粒	wu'shi'cha'ke'li
戊己丸	wu'ji'wan
西瓜霜	xi'gua'shuang
西河柳	xi'he'liu
西红花	xi'hong'hua
西洋参	xi'yang'shen
细辛	xi'xin
夏枯草	xia'ku'cao
夏枯草膏	xia'ku'cao'gao
夏天无	xia'tian'wu
夏天无片	xia'tian'wu'pian
仙茅	xian'mao
香附	xiang'fu
香附丸	xiang'fu'wan
香附丸	xiang'fu'wan
香果脂	xiang'guo'zhi
香加皮	xiang'jia'pi
香连片	xiang'lian'pian
香连丸	xiang'lian'wan
香砂六君丸	xiang'sha'liu'jun'wan
香砂养胃丸	xiang'sha'yang'wei'wan
香砂枳术丸	xiang'sha'zhi'zhu'wan
香苏正胃丸	xiang'su'zheng'wei'wan
香薷	xiang'ru
香橼	xiang'yuan
消咳喘糖浆	xiao'ke'chuan'tang'jiang
消咳喘糖浆	xiao'ke'chuan'tang'jiang
消渴灵片	xiao'ke'ling'pian
消糜栓	xiao'mi'shuan
消食退热糖浆	xiao'shi'tui're'tang'jiang
消栓通络胶囊	xiao'shuan'tong'luo'jiao'nang
消栓通络片	xiao'shuan'tong'luo'pian
消银片	xiao'yin'pian
消瘿丸	xiao'ying'wan
小柴胡颗粒	xiao'chai'hu'ke'li
小柴胡片	xiao'chai'hu'pian
小儿百部止咳糖浆	xiao'er'bai'bu'zhi'ke'tang'jiang
小儿肺热咳喘口服液	xiao'er'fei're'ke'chuan'kou'fu'ye
小儿腹泻宁糖浆	xiao'er'fu'xie'ning
小儿腹泻外敷散	xiao'er'fu'xie'wai'fu'san
小儿肝炎颗粒	xiao'er'gan'yan'ke'li
小儿感冒颗粒	xiao'er'gan'mao'ke'li
小儿化毒散	xiao'er'hua'du'san
小儿化食丸	xiao'er'hua'shi'wan
小儿解表颗粒	xiao'er'jie'biao'ke'li
小儿金丹片	xiao'er'jin'dan'pian
小儿惊风散	xiao'er'jing'feng'san
小儿清热片	xiao'er'qing're'pian
小儿清热止咳口服液	xiao'er'qing're'zhi'ke'kou'fu'ye
小儿热速清口服液	xiao'er're'su'qing'kou'fu'ye
小儿至宝丸	xiao'er'zhi'bao'wan
小活络丸	xiao'huo'luo'wan
小蓟	xiao'ji
小建中合剂	xiao'jian'zhong'he'ji
小金丸	xiao'jin'wan
小青龙合剂	xiao'qing'long'he'ji
小青龙颗粒	xiao'qing'long'ke'li
小通草	xiao'tong'cao
小叶莲	xiao'ye'lian
小茴香	xiao'hui'xiang
辛芩颗粒	xin'qin'ke'li
辛夷	xin'yi
新清宁片	xin'qing'ning'pian
心宁片	xin'ning'pian
心通口服液	xin'tong'kou'fu'ye
杏仁止咳糖浆	xing'ren'zhi'ke'tang'jiang
雄黄	xiong'huang
徐长卿	xu'chang'qing
续断	xu'duan
旋覆花	xuan'fu'hua
玄参	xuan'shen
玄麦甘桔颗粒	xuan'mai'gan'jie'ke'li
玄明粉	xuan'ming'fen
癣湿药水	xuan'shi'yao'shui
鹅掌风药水	e'zhang'feng'yao'shui
血竭	xue'jie
血康口服液	xue'kang'kou'fu'ye
血栓心脉宁胶囊	xue'shuan'xin'mai'ning'jiao'nang
血余炭	xue'yu'tan
血脂灵片	xue'zhi'ling'pian
血脂宁丸	xue'zhi'ning'wan
鸦胆子	ya'dan'zi
鸭跖草	ya'zhi'cao
牙痛一粒丸	ya'tong'yi'li'wan
雅叫哈顿散	ya'jiao'ha'dun'san
亚乎奴	ya'hu'nu
锡生藤	xi'sheng'teng
亚麻子	ya'ma'zi
岩白菜素	yan'bai'cai'su
延胡索	yan'hu'suo
元胡	yuan'hu
羊胆丸	yang'dan'wan
洋参保肺丸	yang'shen'bao'fei'wan
药艾条	yao'ai'tiao
野菊花	ye'ju'hua
野菊花栓	ye'ju'hua'shuan
夜宁糖浆	ye'ning'tang'jiang
一捻金	yi'nian'jin
一清颗粒	yi'qing'ke'li
医痫丸	yi'xian'wan
伊贝母	yi'bei'mu
乙肝宁颗粒	yi'gan'ning'ke'li
益母草	yi'mu'cao
益母草膏	yi'mu'cao'gao
益母草口服液	yi'mu'cao'kou'fu'ye
益母草流浸膏	yi'mu'cao'liu'jing'ao
益气养血口服液	yi'qi'yang'xue'kou'fu'ye
益肾灵颗粒	yi'shen'ling'ke'li
益心通脉颗粒	yi'xin'tong'mai'ke'li
益心酮片	yi'xin'tong'pian
益元散	yi'yuan'san
益智	yi'zhi
茵陈	yin'chen
阴虚胃痛颗粒	yin'xu'wei'tong'ke'li
银柴胡	yin'chai'hu
银黄口服液	yin'huang'kou'fu'ye
银翘解毒胶囊	yin'qiao'jie'du'jiao'nang
银翘解毒颗粒	yin'qiao'jie'du'ke'li
银翘解毒片	yin'qiao'jie'du'pian
银翘解毒丸	yin'qiao'jie'du'wan
银翘双解栓	yin'qiao'shuang'jie'shuan
银杏叶片	yin'xing'ye'pian
银杏叶提取物	yin'xing'ye'ti'qu'wu
淫羊藿	yin'yang'huo
余甘子	yu'gan'zi
驻车丸	zhu'che'wan
壮骨关节丸	zhuang'gu'guan'jie'wan
壮骨伸筋胶囊	zhuang'gu'shen'jin'jiao'nang
滋心阴口服液	zi'xin'yin'kou'fu'ye
紫草	zi'cao
紫草膏	zi'cao'gao
紫河车	zi'he'che
紫花地丁	zi'hua'di'ding
紫金锭	zi'jin'ding
紫石英	zi'shi'ying
紫苏梗	zi'su'geng
紫苏叶	zi'su'ye
紫苏子	zi'su'zi
紫雪	zi'xue
紫菀	zi'wan
自然铜	zi'ran'tong
棕榈	zong'lv
左金胶囊	zuo'jin'jiao'nang
左金丸	zuo'jin'wan
豨莶草	xi'xian'cao
诃子	he'zi
芎菊上清丸	xiong'ju'shang'qing'wan
芫花	yuan'hua
芩暴红止咳片	qin'bao'hong'zhi'ke'pian
芩连片	qin'lian'pian
芡实	qian'shi
苘麻子	qing'ma'zi
荜澄茄	bi'cheng'qie
荜茇	bi'bo
茴香橘核丸	hui'xiang'ju'he'wan
茯苓	fu'ling
茺蔚子	chong'wei'zi
莪术	e'zhu
莪术油	e'zhu'you
莪术油	e'zhu'you
菟丝子	tu'si'zi
葶苈子	ting'li'zi
蒺藜	ji'li
蓼大青叶	liao'da'qing'ye
蕤仁	rui'ren
蕲蛇	qi'she
薤白	xie'bai
薏苡仁	yi'yi'ren
藁本	gao'ben
藿胆丸	huo'dan'wan
藿香正气口服液	huo'xiang'zheng'qi'kou'fu'ye
藿香正气软胶囊	huo'xiang'zheng'qi'ruan'jiao'nang
藿香正气水	huo'xiang'zheng'qi'shui
逍遥丸	xiao'yao'wan
娑罗子	suo'lou'zi
琥珀抱龙丸	hu'po'bao'long'wan
杞菊地黄丸	qi'ju'di'huang'wan
枇杷叶	pi'pa'ye
枇杷叶膏	pi'pa'ye'gao
枳壳	zhi'ke
枳实	zhi'shi
枳实导滞丸	zhi'shi'dao'zhi'wan
枳术丸	zhi'zhu'wan
栀子	zhi'zi
栀子金花丸	zhi'zi'jin'hua'wan
枸骨叶	gou'gu'ye
枸杞子	gou'qi'zi
桉油	an'you
楮实子	chu'shi'zi
楮实子	chu'shi'zi
榧子	fei'zi
槟榔	bing'lang
槟榔四消丸	bing'lang'si'xiao'wan
槲寄生	hu'ji'sheng
橘核	ju'he
橘红	ju'hong
橘红痰咳液	ju'hong'tan'ke'ye
橘红丸	ju'hong'wan
煅石膏	duan'shi'gao
祛风舒筋丸	qu'feng'shu'jin'wan
祛风舒筋丸	qu'feng'shu'jin'wan
礞石滚痰丸	meng'shi'gun'tan'wan
蠲哮片	juan'xiao'pian
蠲哮片	juan'xiao'pian
疳积散	gan'ji'san
痧药	sha'yao
癃清片	long'qing'pian
蜈蚣	wu'gong
蟾酥	chan'su
罂粟壳	ying'su'ke
瞿麦	qu'mai
麝香	she'xiang
麝香	she'xiang
麝香痔疮栓	she'xiang'zhi'chuang'shuan
麝香祛痛搽剂	she'xiang'qu'tong'cha'ji
麝香祛痛气雾剂	she'xiang'qu'tong'qi'wu'ji
黛蛤散	dai'ge'san
干姜	gan'jiang
