// 四字成语 8011 个 拼音正确
哀哀父母	ai'ai'fu'mu	1
哀哀欲绝	ai'ai'yu'jue	1
爱别离苦	ai'bie'li'ku	1
哀兵必胜	ai'bing'bi'sheng	1
爱不忍释	ai'bu'ren'shi	1
爱不释手	ai'bu'shi'shou	1
爱才如渴	ai'cai'ru'ke	1
爱财如命	ai'cai'ru'ming	1
爱才若渴	ai'cai'ruo'ke	1
哀而不伤	ai'er'bu'shang	1
挨风缉缝	ai'feng'ji'feng	1
哀感天地	ai'gan'tian'di	1
哀感顽艳	ai'gan'wan'yan	1
哀感中年	ai'gan'zhong'nian	1
哀告宾服	ai'gao'bin'fu	1
爱国如家	ai'guo'ru'jia	1
爱鹤失众	ai'he'shi'zhong	1
哀鸿遍野	ai'hong'bian'ye	1
哀毁骨立	ai'hui'gu'li	1
挨家挨户	ai'jia'ai'hu	1
挨肩并足	ai'jian'bing'zu	1
挨肩擦膀	ai'jian'ca'bang	1
挨肩擦背	ai'jian'ca'bei	1
挨肩擦脸	ai'jian'ca'lian	1
挨肩搭背	ai'jian'da'bei	1
碍口识羞	ai'kou'shi'xiu	1
爱礼存羊	ai'li'cun'yang	1
哀梨蒸食	ai'li'zheng'shi	1
爱毛反裘	ai'mao'fan'qiu	1
暧昧不明	ai'mei'bu'ming	1
暧昧之情	ai'mei'zhi'qing	1
挨门逐户	ai'men'zhu'hu	1
爱民如子	ai'min'ru'zi	1
爱莫能助	ai'mo'neng'zhu	1
爱钱如命	ai'qian'ru'ming	1
蔼然可亲	ai'ran'ke'qin	1
蔼然仁者	ai'ran'ren'zhe	1
爱人好士	ai'ren'hao'shi	1
矮人看场	ai'ren'kan'chang	1
爱人利物	ai'ren'li'wu	1
爱人以德	ai'ren'yi'de	1
爱日惜力	ai'ri'xi'li	1
爱如己出	ai'ru'ji'chu	1
爱如珍宝	ai'ru'zhen'bao	1
挨三顶五	ai'san'ding'wu	1
挨山塞海	ai'shan'se'hai	1
唉声叹气	ai'sheng'tan'qi	1
碍手碍脚	ai'shou'ai'jiao	1
哀丝豪竹	ai'si'hao'zhu	1
哀思如潮	ai'si'ru'chao	1
爱素好古	ai'su'hao'gu	1
哀天叫地	ai'tian'jiao'di	1
哀痛欲绝	ai'tong'yu'jue	1
爱屋及乌	ai'wu'ji'wu	1
爱惜羽毛	ai'xi'yu'mao	1
爱憎分明	ai'zeng'fen'ming	1
矮子看戏	ai'zi'kan'xi	1
安安稳稳	an'an'wen'wen	1
安邦定国	an'bang'ding'guo	1
安邦治国	an'bang'zhi'guo	1
按兵不动	an'bing'bu'dong	1
安步当车	an'bu'dang'che	1
按部就班	an'bu'jiu'ban	1
安不忘危	an'bu'wang'wei	1
安常处顺	an'chang'chu'shun	1
安常守分	an'chang'shou'fen	1
安常守故	an'chang'shou'gu	1
安车蒲轮	an'che'pu'lun	1
暗淡无光	an'dan'wu'guang	1
暗渡陈仓	an'du'chen'cang	1
案牍劳形	an'du'lao'xing	1
安堵乐业	an'du'le'ye	1
安堵如故	an'du'ru'gu	1
安分守己	an'fen'shou'ji	1
安分知足	an'fen'zhi'zu	1
安富恤贫	an'fu'xu'pin	1
安富尊荣	an'fu'zun'rong	1
安国宁家	an'guo'ning'jia	1
安魂定魄	an'hun'ding'po	1
安家立业	an'jia'li'ye	1
安家落户	an'jia'luo'hu	1
按甲寝兵	an'jia'qin'bing	1
按甲休兵	an'jia'xiu'bing	1
暗箭难防	an'jian'nan'fang	1
暗箭伤人	an'jian'shang'ren	1
安居乐业	an'ju'le'ye	1
安老怀少	an'lao'huai'shao	1
安良除暴	an'liang'chu'bao	1
鞍马劳顿	an'ma'lao'dun	1
鞍马劳困	an'ma'lao'kun	1
鞍马之劳	an'ma'zhi'lao	1
安眉带眼	an'mei'dai'yan	1
暗昧之事	an'mei'zhi'shi	1
安民告示	an'min'gao'shi	1
按名责实	an'ming'ze'shi	1
按捺不住	an'na'bu'zhu	1
安内攘外	an'nei'rang'wai	1
按辔徐行	an'pei'xu'xing	1
安贫乐道	an'pin'le'dao	1
安贫乐贱	an'pin'le'jian	1
暗气暗恼	an'qi'an'nao	1
鞍前马后	an'qian'ma'hou	1
安然如故	an'ran'ru'gu	1
黯然伤神	an'ran'shang'shen	1
黯然失色	an'ran'shi'se	1
安然无事	an'ran'wu'shi	1
安然无恙	an'ran'wu'yang	1
黯然销魂	an'ran'xiao'hun	1
安忍无亲	an'ren'wu'qin	1
安如磐石	an'ru'pan'shi	1
安如泰山	an'ru'tai'shan	1
暗弱无断	an'ruo'wu'duan	1
安身立命	an'shen'li'ming	1
安身为乐	an'shen'wei'le	1
安身之处	an'shen'zhi'chu	1
安身之地	an'shen'zhi'di	1
暗室不欺	an'shi'bu'qi	1
安时处顺	an'shi'chu'shun	1
暗室逢灯	an'shi'feng'deng	1
暗室亏心	an'shi'kui'xin	1
安室利处	an'shi'li'chu	1
暗室欺心	an'shi'qi'xin	1
暗室求物	an'shi'qiu'wu	1
安适如常	an'shi'ru'chang	1
暗送秋波	an'song'qiu'bo	1
按图索骥	an'tu'suo'ji	1
安土重迁	an'tu'zhong'qian	1
安危相易	an'wei'xiang'yi	1
安危与共	an'wei'yu'gong	1
暗无天日	an'wu'tian'ri	1
安闲自得	an'xian'zi'de	1
安闲自在	an'xian'zi'zai	1
暗香疏影	an'xiang'shu'ying	1
安心定志	an'xin'ding'zhi	1
按行自抑	an'xing'zi'yi	1
安营扎寨	an'ying'zha'zhai	1
安于现状	an'yu'xian'zhuang	1
安于一隅	an'yu'yi'yu	1
安宅正路	an'zhai'zheng'lu	1
安枕而卧	an'zhen'er'wo	1
安之若命	an'zhi'ruo'ming	1
安之若素	an'zhi'ruo'su	1
暗中摸索	an'zhong'mo'suo	1
安坐待毙	an'zuo'dai'bi	1
昂藏七尺	ang'cang'qi'chi	1
昂然自得	ang'ran'zi'de	1
昂首阔步	ang'shou'kuo'bu	1
昂首伸眉	ang'shou'shen'mei	1
昂首天外	ang'shou'tian'wai	1
昂首挺胸	ang'shou'ting'xiong	1
昂首望天	ang'shou'wang'tian	1
盎盂相击	ang'yu'xiang'ji	1
盎盂相敲	ang'yu'xiang'qiao	1
嗷嗷待哺	ao'ao'dai'bu	1
傲不可长	ao'bu'ke'zhang	1
熬肠刮肚	ao'chang'gua'du	1
熬更守夜	ao'geng'shou'ye	1
傲骨嶙嶙	ao'gu'lin'lin	1
懊悔无及	ao'hui'wu'ji	1
熬姜呷醋	ao'jiang'xia'cu	1
傲慢不逊	ao'man'bu'xun	1
傲慢少礼	ao'man'shao'li	1
奥妙无穷	ao'miao'wu'qiong	1
傲睨得志	ao'ni'de'zhi	1
傲睨万物	ao'ni'wan'wu	1
傲睨一世	ao'ni'yi'shi	1
傲睨自若	ao'ni'zi'ruo	1
熬清守淡	ao'qing'shou'dan	1
傲然屹立	ao'ran'yi'li	1
傲世轻物	ao'shi'qing'wu	1
傲霜斗雪	ao'shuang'dou'xue	1
傲头傲脑	ao'tou'ao'nao	1
傲贤慢士	ao'xian'man'shi	1
熬心费力	ao'xin'fei'li	1
傲雪凌霜	ao'xue'ling'shuang	1
傲雪欺霜	ao'xue'qi'shuang	1
八百孤寒	ba'bai'gu'han	1
八拜之交	ba'bai'zhi'jiao	1
拔本塞源	ba'ben'se'yuan	1
把臂入林	ba'bi'ru'lin	1
把持不定	ba'chi'bu'ding	1
罢黜百家	ba'chu'bai'jia	1
拔萃出群	ba'cui'chu'qun	1
拔刀相助	ba'dao'xiang'zhu	1
拔地摇山	ba'di'yao'shan	1
拔地倚天	ba'di'yi'tian	1
拔丁抽楔	ba'ding'chou'xie	1
八斗之才	ba'dou'zhi'cai	1
把饭叫饥	ba'fan'jiao'ji	1
八方呼应	ba'fang'hu'ying	1
巴高望上	ba'gao'wang'shang	1
跋扈自恣	ba'hu'zi'zi	1
八荒之外	ba'huang'zhi'wai	1
八街九陌	ba'jie'jiu'mo	1
拔葵啖枣	ba'kui'dan'zao	1
拔葵去织	ba'kui'qu'zhi	1
拔来报往	ba'lai'fu'wang	1
霸陵醉尉	ba'ling'zui'wei	1
拔茅连茹	ba'mao'lian'ru	1
八面见光	ba'mian'jian'guang	1
八面玲珑	ba'mian'ling'long	1
八面威风	ba'mian'wei'feng	1
八面莹澈	ba'mian'ying'che	1
八面圆通	ba'mian'yuan'tong	1
八面张罗	ba'mian'zhang'luo	1
拔苗助长	ba'miao'zhu'zhang	1
巴前算后	ba'qian'suan'hou	1
跋前踬后	ba'qian'zhi'hou	1
巴三览四	ba'san'lan'si	1
拔山超海	ba'shan'chao'hai	1
拔山盖世	ba'shan'gai'shi	1
拔山扛鼎	ba'shan'gang'ding	1
跋山涉水	ba'shan'she'shui	1
巴山蜀水	ba'shan'shu'shui	1
巴山夜雨	ba'shan'ye'yu	1
拔十得五	ba'shi'de'wu	1
拔树寻根	ba'shu'xun'gen	1
把素持斋	ba'su'chi'zhai	1
巴头探脑	ba'tou'tan'nao	1
把玩无厌	ba'wan'wu'yan	1
霸王别姬	ba'wang'bie'ji	1
霸王风月	ba'wang'feng'yue	1
拔犀擢象	ba'xi'zhuo'xiang	1
拔新领异	ba'xin'ling'yi	1
八音迭奏	ba'yin'die'zou	1
拔宅上升	ba'zhai'shang'sheng	1
八珍玉食	ba'zhen'yu'shi	1
拔帜易帜	ba'zhi'yi'zhi	1
八字打开	ba'zi'da'kai	1
百般刁难	bai'ban'diao'nan	1
百般奉承	bai'ban'feng'cheng	1
百弊丛生	bai'bi'cong'sheng	1
白璧青蝇	bai'bi'qing'ying	1
白璧微瑕	bai'bi'wei'xia	1
白璧无瑕	bai'bi'wu'xia	1
百步穿杨	bai'bu'chuan'yang	1
百不失一	bai'bu'shi'yi	1
百不一存	bai'bu'yi'cun	1
百川归海	bai'chuan'gui'hai	1
百辞莫辩	bai'ci'mo'bian	1
百代过客	bai'dai'guo'ke	1
百代文宗	bai'dai'wen'zong	1
拜倒辕门	bai'dao'yuan'men	1
败德辱行	bai'de'ru'xing	1
白丁俗客	bai'ding'su'ke	1
百读不厌	bai'du'bu'yan	1
百堵皆作	bai'du'jie'zuo	1
百端待举	bai'duan'dai'ju	1
拜恩私室	bai'en'si'shi	1
百发百中	bai'fa'bai'zhong	1
白发苍颜	bai'fa'cang'yan	1
白发红颜	bai'fa'hong'yan	1
白发千丈	bai'fa'qian'zhang	1
白发青衫	bai'fa'qing'shan	1
白饭青刍	bai'fan'qing'chu	1
百废待举	bai'fei'dai'ju	1
百废俱兴	bai'fei'ju'xing	1
百感交集	bai'gan'jiao'ji	1
败鼓之皮	bai'gu'zhi'pi	1
稗官野史	bai'guan'ye'shi	1
白圭之玷	bai'gui'zhi'dian	1
白黑分明	bai'hei'fen'ming	1
白虹贯日	bai'hong'guan'ri	1
百花齐放	bai'hua'qi'fang	1
百花生日	bai'hua'sheng'ri	1
白华之怨	bai'hua'zhi'yuan	1
百卉千葩	bai'hui'qian'pa	1
百家争鸣	bai'jia'zheng'ming	1
拜将封侯	bai'jiang'feng'hou	1
百举百全	bai'ju'bai'quan	1
白驹过隙	bai'ju'guo'xi	1
白驹空谷	bai'ju'kong'gu	1
败军之将	bai'jun'zhi'jiang	1
百孔千疮	bai'kong'qian'chuang	1
百口莫辩	bai'kou'mo'bian	1
白蜡明经	bai'la'ming'jing	1
百里挑一	bai'li'tiao'yi	1
百炼成钢	bai'lian'cheng'gang	1
百了千当	bai'liao'qian'dang	1
败鳞残甲	bai'lin'can'jia	1
百伶百俐	bai'ling'bai'li	1
百龄眉寿	bai'ling'mei'shou	1
败柳残花	bai'liu'can'hua	1
白龙鱼服	bai'long'yu'fu	1
白旄黄钺	bai'mao'huang'yue	1
白眉赤眼	bai'mei'chi'yan	1
白面书生	bai'mian'shu'sheng	1
百年不遇	bai'nian'bu'yu	1
百年大计	bai'nian'da'ji	1
百念皆灰	bai'nian'jie'hui	1
百年难遇	bai'nian'nan'yu	1
百年树人	bai'nian'shu'ren	1
百年偕老	bai'nian'xie'lao	1
百年之柄	bai'nian'zhi'bing	1
百年之好	bai'nian'zhi'hao	1
百年之后	bai'nian'zhi'hou	1
百鸟朝凤	bai'niao'chao'feng	1
百巧千穷	bai'qiao'qian'qiong	1
白日见鬼	bai'ri'jian'gui	1
白日升天	bai'ri'sheng'tian	1
白日衣绣	bai'ri'yi'xiu	1
白日做梦	bai'ri'zuo'meng	1
白山黑水	bai'shan'hei'shui	1
百舍重茧	bai'she'chong'jian	1
百舌之声	bai'she'zhi'sheng	1
百身何赎	bai'shen'he'shu	1
百身莫赎	bai'shen'mo'shu	1
百世不磨	bai'shi'bu'mo	1
白首北面	bai'shou'bei'mian	1
白首空归	bai'shou'kong'gui	1
白手起家	bai'shou'qi'jia	1
白首穷经	bai'shou'qiong'jing	1
百兽率舞	bai'shou'shuai'wu	1
白首相知	bai'shou'xiang'zhi	1
白首之心	bai'shou'zhi'xin	1
白水鉴心	bai'shui'jian'xin	1
百思不解	bai'si'bu'jie	1
百岁千秋	bai'sui'qian'qiu	1
白头如新	bai'tou'ru'xin	1
白头相守	bai'tou'xiang'shou	1
白头偕老	bai'tou'xie'lao	1
百万雄师	bai'wan'xiong'shi	1
白往黑来	bai'wang'hei'lai	1
白屋寒门	bai'wu'han'men	1
百无禁忌	bai'wu'jin'ji	1
百无聊赖	bai'wu'liao'lai	1
百无一能	bai'wu'yi'neng	1
百无一失	bai'wu'yi'shi	1
百无一是	bai'wu'yi'shi	1
百无一用	bai'wu'yi'yong	1
摆袖却金	bai'xiu'que'jin	1
白雪皑皑	bai'xue'ai'ai	1
白眼相看	bai'yan'xiang'kan	1
百业萧条	bai'ye'xiao'tiao	1
百依百顺	bai'yi'bai'shun	1
百衣百随	bai'yi'bai'sui	1
白衣公卿	bai'yi'gong'qing	1
白衣卿相	bai'yi'qing'xiang	1
白衣秀士	bai'yi'xiu'shi	1
白鱼入舟	bai'yu'ru'zhou	1
白云苍狗	bai'yun'cang'gou	1
白云孤飞	bai'yun'gu'fei	1
白云亲舍	bai'yun'qin'she	1
百战百胜	bai'zhan'bai'sheng	1
百战不殆	bai'zhan'bu'dai	1
百折不回	bai'zhe'bu'hui	1
百折不挠	bai'zhe'bu'nao	1
白纸黑字	bai'zhi'hei'zi	1
半壁江山	ban'bi'jiang'shan	1
斑驳陆离	ban'bo'lu'li	1
半部论语	ban'bu'lun'yu	1
半筹不纳	ban'chou'bu'na	1
搬唇递舌	ban'chun'di'she	1
半间不界	ban'gan'bu'ga	1
半截入土	ban'jie'ru'tu	1
半斤八两	ban'jin'ba'liang	1
搬斤播两	ban'jin'bo'liang	1
班荆道故	ban'jing'dao'gu	1
半路出家	ban'lu'chu'jia	1
班门弄斧	ban'men'nong'fu	1
半面之交	ban'mian'zhi'jiao	1
半面之旧	ban'mian'zhi'jiu	1
搬弄是非	ban'nong'shi'fei	1
半青半黄	ban'qing'ban'huang	1
板上钉钉	ban'shang'ding'ding	1
阪上走丸	ban'shang'zou'wan	1
半身不遂	ban'shen'bu'sui	1
班师回朝	ban'shi'hui'chao	1
搬石砸脚	ban'shi'za'jiao	1
伴食宰相	ban'shi'zai'xiang	1
半死不活	ban'si'bu'huo	1
半途而废	ban'tu'er'fei	1
半推半就	ban'tui'ban'jiu	1
半吞半吐	ban'tun'ban'tu	1
半信半疑	ban'xin'ban'yi	1
半夜三更	ban'ye'san'geng	1
蚌病成珠	bang'bing'cheng'zhu	1
棒打鸳鸯	bang'da'yuan'yang	1
傍观冷眼	bang'guan'leng'yan	1
帮虎吃食	bang'hu'chi'shi	1
傍花随柳	bang'hua'sui'liu	1
傍人篱壁	bang'ren'li'bi	1
傍人门户	bang'ren'men'hu	1
榜上无名	bang'shang'wu'ming	1
帮闲钻懒	bang'xian'zuan'lan	1
报本反始	bao'ben'fan'shi	1
报冰公事	bao'bing'gong'shi	1
抱布贸丝	bao'bu'mao'si	1
抱残守缺	bao'can'shou'que	1
包藏祸心	bao'cang'huo'xin	1
抱诚守真	bao'cheng'shou'zhen	1
报仇雪恨	bao'chou'xue'hen	1
薄唇轻言	bao'chun'qing'yan	1
宝刀不老	bao'dao'bu'lao	1
抱法处势	bao'fa'chu'shi	1
暴风骤雨	bao'feng'zhou'yu	1
抱关击柝	bao'guan'ji'tuo	1
保国安民	bao'guo'an'min	1
抱恨黄泉	bao'hen'huang'quan	1
抱恨终天	bao'hen'zhong'tian	1
暴虎冯河	bao'hu'ping'he	1
饱经沧桑	bao'jing'cang'sang	1
饱经风霜	bao'jing'feng'shuang	1
保境息民	bao'jing'xi'min	1
苞苴竿牍	bao'ju'gan'du	1
包举宇内	bao'ju'yu'nei	1
暴戾恣睢	bao'li'zi'sui	1
抱令守律	bao'ling'shou'lv	1
暴露无遗	bao'lu'wu'yi	1
包罗万象	bao'luo'wan'xiang	1
宝马香车	bao'ma'xiang'che	1
暴虐无道	bao'nve'wu'dao	1
暴取豪夺	bao'qu'hao'duo	1
褒善贬恶	bao'shan'bian'e	1
宝山空回	bao'shan'kong'hui	1
饱食暖衣	bao'shi'nuan'yi	1
饱食终日	bao'shi'zhong'ri	1
豹死留皮	bao'si'liu'pi	1
暴殄天物	bao'tian'tian'wu	1
暴跳如雷	bao'tiao'ru'lei	1
抱头大哭	bao'tou'da'ku	1
豹头环眼	bao'tou'huan'yan	1
抱头鼠窜	bao'tou'shu'cuan	1
抱蔓摘瓜	bao'wan'zhai'gua	1
抱瓮出灌	bao'weng'chu'guan	1
抱薪救火	bao'xin'jiu'huo	1
包羞忍耻	bao'xiu'ren'chi	1
饱学之士	bao'xue'zhi'shi	1
褒衣博带	bao'yi'bo'dai	1
饱以老拳	bao'yi'lao'quan	1
褒衣危冠	bao'yi'wei'guan	1
鲍鱼之肆	bao'yu'zhi'si	1
抱怨雪耻	bao'yuan'xue'chi	1
宝珠市饼	bao'zhu'shi'bing	1
抱子弄孙	bao'zi'nong'sun	1
背本趋末	bei'ben'qu'mo	1
卑鄙龌龊	bei'bi'wo'chuo	1
卑鄙无耻	bei'bi'wu'chi	1
悲不自胜	bei'bu'zi'sheng	1
卑谄足恭	bei'chan'ju'gong	1
备尝艰苦	bei'chang'jian'ku	1
备尝辛苦	bei'chang'xin'ku	1
背城借一	bei'cheng'jie'yi	1
背城一战	bei'cheng'yi'zhan	1
悲愁垂涕	bei'chou'chui'ti	1
卑辞重币	bei'ci'zhong'bi	1
背道而驰	bei'dao'er'chi	1
倍道而进	bei'dao'er'jin	1
北道主人	bei'dao'zhu'ren	1
北斗之尊	bei'dou'zhi'zun	1
备多力分	bei'duo'li'fen	1
背恩忘义	bei'en'wang'yi	1
备而不用	bei'er'bu'yong	1
悲愤填膺	bei'fen'tian'ying	1
北风之恋	bei'feng'zhi'lian	1
杯觥交错	bei'gong'jiao'cuo	1
卑躬屈膝	bei'gong'qu'xi	1
杯弓蛇影	bei'gong'she'ying	1
北宫婴儿	bei'gong'ying'er	1
陂湖禀量	bei'hu'bing'liang	1
悲欢离合	bei'huan'li'he	1
背井离乡	bei'jing'li'xiang	1
杯酒戈矛	bei'jiu'ge'mao	1
杯酒言欢	bei'jiu'yan'huan	1
卑礼厚币	bei'li'hou'bi	1
北门南牙	bei'men'nan'ya	1
北门锁钥	bei'men'suo'yue	1
背盟败约	bei'meng'bai'yue	1
北面称臣	bei'mian'cheng'chen	1
杯盘狼藉	bei'pan'lang'ji	1
贝阙珠宫	bei'que'zhu'gong	1
倍日并行	bei'ri'bing'xing	1
悖入悖出	bei'ru'bei'chu	1
背山起楼	bei'shan'qi'lou	1
杯水车薪	bei'shui'che'xin	1
背水一战	bei'shui'yi'zhan	1
北叟失马	bei'sou'shi'ma	1
悲天悯人	bei'tian'min'ren	1
备位充数	bei'wei'chong'shu	1
悲喜交集	bei'xi'jiao'ji	1
背信弃义	bei'xin'qi'yi	1
北辕适楚	bei'yuan'shi'chu	1
本来面目	ben'lai'mian'mu	1
本末倒置	ben'mo'dao'zhi	1
笨鸟先飞	ben'niao'xian'fei	1
本同末异	ben'tong'mo'yi	1
本相毕露	ben'xiang'bi'lu	1
本小利微	ben'xiao'li'wei	1
本性难移	ben'xing'nan'yi	1
奔逸绝尘	ben'yi'jue'chen	1
奔走呼号	ben'zou'hu'hao	1
奔走相告	ben'zou'xiang'gao	1
奔走钻营	ben'zou'zuan'ying	1
笨嘴拙舌	ben'zui'zhuo'she	1
笔饱墨酣	bi'bao'mo'han	1
比比皆是	bi'bi'jie'shi	1
必不挠北	bi'bu'nao'bei	1
匕鬯不惊	bi'chang'bu'jing	1
彼倡此和	bi'chang'ci'he	1
弊车羸马	bi'che'lei'ma	1
蔽聪塞明	bi'cong'se'ming	1
笔大如椽	bi'da'ru'chuan	1
避而不谈	bi'er'bu'tan	1
笔耕砚田	bi'geng'yan'tian	1
必恭必敬	bi'gong'bi'jing	1
毕恭毕敬	bi'gong'bi'jing	1
敝鼓丧豚	bi'gu'sang'tun	1
闭关却扫	bi'guan'que'sao	1
闭关锁国	bi'guan'suo'guo	1
闭关自守	bi'guan'zi'shou	1
避害就利	bi'hai'jiu'li	1
碧海青天	bi'hai'qing'tian	1
闭户读书	bi'hu'du'shu	1
避祸就福	bi'huo'jiu'fu	1
比肩并起	bi'jian'bing'qi	1
比肩而立	bi'jian'er'li	1
比肩继踵	bi'jian'ji'zhong	1
比肩齐声	bi'jian'qi'sheng	1
彼竭我盈	bi'jie'wo'ying	1
弊绝风清	bi'jue'feng'qing	1
避坑落井	bi'keng'luo'jing	1
闭口不言	bi'kou'bu'yan	1
闭口藏舌	bi'kou'cang'she	1
比类从事	bi'lei'cong'shi	1
壁垒森严	bi'lei'sen'yan	1
必里迟离	bi'li'chi'li	1
壁立千仞	bi'li'qian'ren	1
髀里肉生	bi'li'rou'sheng	1
鄙吝复萌	bi'lin'fu'meng	1
筚路蓝缕	bi'lu'lan'lv	1
碧落黄泉	bi'luo'huang'quan	1
筚门闺窦	bi'men'gui'dou	1
闭门酣歌	bi'men'han'ge	1
闭门觅句	bi'men'mi'ju	1
闭门却扫	bi'men'que'sao	1
闭门思过	bi'men'si'guo	1
闭门投辖	bi'men'tou'xia	1
闭门造车	bi'men'zao'che	1
笔墨官司	bi'mo'guan'si	1
闭目塞听	bi'mu'se'ting	1
避让贤路	bi'rang'xian'lu	1
蔽日干云	bi'ri'gan'yun	1
髀肉复生	bi'rou'fu'sheng	1
笔扫千军	bi'sao'qian'jun	1
逼上梁山	bi'shang'liang'shan	1
避实击虚	bi'shi'ji'xu	1
避实就虚	bi'shi'jiu'xu	1
避世绝俗	bi'shi'jue'su	1
比物此志	bi'wu'ci'zhi	1
比屋可封	bi'wu'ke'feng	1
鼻息如雷	bi'xi'ru'lei	1
笔下超生	bi'xia'chao'sheng	1
笔下生花	bi'xia'sheng'hua	1
避凶趋吉	bi'xiong'qu'ji	1
碧血丹心	bi'xue'dan'xin	1
比翼连枝	bi'yi'lian'zhi	1
比翼齐飞	bi'yi'qi'fei	1
比翼双飞	bi'yi'shuang'fei	1
必由之路	bi'you'zhi'lu	1
鄙于不屑	bi'yu'bu'xie	1
闭月羞花	bi'yue'xiu'hua	1
必争之地	bi'zheng'zhi'di	1
避重就轻	bi'zhong'jiu'qing	1
彼众我寡	bi'zhong'wo'gua	1
币重言甘	bi'zhong'yan'gan	1
敝帚千金	bi'zhou'qian'jin	1
敝帚自珍	bi'zhou'zi'zhen	1
俾昼作夜	bi'zhou'zuo'ye	1
笔诛墨伐	bi'zhu'mo'fa	1
笔走龙蛇	bi'zou'long'she	1
婢作夫人	bi'zuo'fu'ren	1
变本加厉	bian'ben'jia'li	1
鞭辟近里	bian'bi'jin'li	1
辩才无碍	bian'cai'wu'ai	1
鞭长莫及	bian'chang'mo'ji	1
便辞巧说	bian'ci'qiao'shuo	1
遍地开花	bian'di'kai'hua	1
抃风舞润	bian'feng'wu'run	1
变古易常	bian'gu'yi'chang	1
变化多端	bian'hua'duo'duan	1
变化莫测	bian'hua'mo'ce	1
变化无常	bian'hua'wu'chang	1
变化无穷	bian'hua'wu'qiong	1
变幻莫测	bian'huan'mo'ce	1
变幻无常	bian'huan'wu'chang	1
变名易姓	bian'ming'yi'xing	1
鞭辟入里	bian'pi'ru'li	1
变色易容	bian'se'yi'rong	1
变色之言	bian'se'zhi'yan	1
变生不测	bian'sheng'bu'ce	1
变生肘腋	bian'sheng'zhou'ye	1
遍体鳞伤	bian'ti'lin'shang	1
变危为安	bian'wei'wei'an	1
便宜行事	bian'yi'xing'shi	1
彪炳千古	biao'bing'qian'gu	1
飙举电至	biao'ju'dian'zhi	1
表里如一	biao'li'ru'yi	1
表里山河	biao'li'shan'he	1
表里受敌	biao'li'shou'di	1
表里为奸	biao'li'wei'jian	1
摽梅之年	biao'men'zhi'nian	1
表面文章	biao'mian'wen'zhang	1
标同伐异	biao'tong'fa'yi	1
标新立异	biao'xin'li'yi	1
彪形大汉	biao'xing'da'han	1
别出机杼	bie'chu'ji'zhu	1
别出心裁	bie'chu'xin'cai	1
别风淮雨	bie'feng'huai'yu	1
别鹤孤鸾	bie'he'gu'luan	1
别具肺肠	bie'ju'fei'chang	1
别具匠心	bie'ju'jiang'xin	1
别具一格	bie'ju'yi'ge	1
别具只眼	bie'ju'zhi'yan	1
别开生面	bie'kai'sheng'mian	1
别来无恙	bie'lai'wu'yang	1
别树一帜	bie'shu'yi'zhi	1
别无长物	bie'wu'chang'wu	1
别有洞天	bie'you'dong'tian	1
别有肺肠	bie'you'fei'chang	1
别有风趣	bie'you'feng'qu	1
别有风味	bie'you'feng'wei	1
别有天地	bie'you'tian'di	1
别有用心	bie'you'yong'xin	1
彬彬有礼	bin'bin'you'li	1
宾客如云	bin'ke'ru'yun	1
鬓乱钗横	bin'luan'chai'heng	1
宾至如归	bin'zhi'ru'gui	1
秉笔直书	bing'bi'zhi'shu	1
病病歪歪	bing'bing'wai'wai	1
兵不血刃	bing'bu'xue'ren	1
兵不厌诈	bing'bu'yan'zha	1
兵不由将	bing'bu'you'jiang	1
兵车之会	bing'che'zhi'hui	1
病从口入	bing'cong'kou'ru	1
并蒂芙蓉	bing'di'fu'rong	1
兵多将广	bing'duo'jiang'guang	1
兵多者败	bing'duo'zhe'bai	1
秉公办理	bing'gong'ban'li	1
秉公无私	bing'gong'wu'si	1
病骨支离	bing'gu'zhi'li	1
兵贵神速	bing'gui'shen'su	1
兵贵先声	bing'gui'xian'sheng	1
冰寒于水	bing'han'yu'shui	1
冰壶秋月	bing'hu'qiu'yue	1
兵荒马乱	bing'huang'ma'luan	1
冰魂雪魄	bing'hun'xue'po	1
冰肌雪肠	bing'ji'xue'chang	1
冰肌玉骨	bing'ji'yu'gu	1
并驾齐驱	bing'jia'qi'qu	1
冰解冻释	bing'jie'dong'shi	1
兵连祸结	bing'lian'huo'jie	1
兵临城下	bing'lin'cheng'xia	1
病民蛊国	bing'min'gu'guo	1
病魔缠身	bing'mo'chan'shen	1
屏气敛息	bing'qi'lian'xi	1
屏气凝神	bing'qi'ning'shen	1
兵强马壮	bing'qiang'ma'zhuang	1
冰清玉洁	bing'qing'yu'jie	1
冰清玉润	bing'qing'yu'run	1
并日而食	bing'ri'er'shi	1
兵戎相见	bing'rong'xiang'jian	1
病入膏肓	bing'ru'gao'huang	1
病入骨髓	bing'ru'gu'sui	1
冰山难靠	bing'shan'nan'kao	1
屏声息气	bing'sheng'xi'qi	1
冰炭不投	bing'tan'bu'tou	1
冰天雪地	bing'tian'xue'di	1
冰天雪窑	bing'tian'xue'jiao	1
兵微将寡	bing'wei'jiang'gua	1
并为一谈	bing'wei'yi'tan	1
兵无常势	bing'wu'chang'shi	1
冰消瓦解	bing'xiao'wa'jie	1
并行不悖	bing'xing'bu'bei	1
兵行诡道	bing'xing'gui'dao	1
禀性难移	bing'xing'nan'yi	1
冰雪聪明	bing'xue'cong'ming	1
秉要执本	bing'yao'zhi'ben	1
兵在其颈	bing'zai'qi'jing	1
秉烛待旦	bing'zhu'dai'dan	1
炳烛夜游	bing'zhu'ye'you	1
秉烛夜游	bing'zhu'ye'you	1
跛鳖千里	bo'bie'qian'li	1
博采众长	bo'cai'zhong'chang	1
拨草寻蛇	bo'cao'xun'she	1
剥床及肤	bo'chuang'ji'fu	1
博大精深	bo'da'jing'shen	1
伯道无儿	bo'dao'wu'er	1
博而不精	bo'er'bu'jing	1
博而寡要	bo'er'gua'yao	1
剥肤之痛	bo'fu'zhi'tong	1
伯歌季舞	bo'ge'ji'wu	1
博古通今	bo'gu'tong'jin	1
波光粼粼	bo'guang'lin'lin	1
薄寒中人	bo'han'zhong'ren	1
擘肌分理	bo'ji'fen'li	1
薄技在身	bo'ji'zai'shen	1
波谲云诡	bo'jue'yun'gui	1
播糠眯目	bo'kang'mi'mu	1
波澜老成	bo'lan'lao'cheng	1
博览群书	bo'lan'qun'shu	1
波澜壮阔	bo'lan'zhuang'kuo	1
伯乐相马	bo'le'xiang'ma	1
拨乱反正	bo'luan'fan'zheng	1
薄命佳人	bo'ming'jia'ren	1
搏牛之虻	bo'niu'zhi'meng	1
博洽多闻	bo'qia'duo'wen	1
勃然变色	bo'ran'bian'se	1
勃然大怒	bo'ran'da'nu	1
勃然奋励	bo'ran'fen'li	1
博识多通	bo'shi'duo'tong	1
博施济众	bo'shi'ji'zhong	1
博士买驴	bo'shi'mai'lv	1
博硕肥腯	bo'shuo'fei'tu	1
波涛汹涌	bo'tao'xiong'yong	1
博通经籍	bo'tong'jing'ji	1
博闻辩言	bo'wen'bian'yan	1
博闻强记	bo'wen'qiang'ji	1
博闻强识	bo'wen'qiang'zhi	1
博文约礼	bo'wen'yue'li	1
博物洽闻	bo'wu'qia'wen	1
薄物细故	bo'wu'xi'gu	1
博学多才	bo'xue'duo'cai	1
博学多闻	bo'xue'duo'wen	1
伯埙仲篪	bo'xun'zhong'chi	1
伯玉知非	bo'yu'zhi'fei	1
拨云见日	bo'yun'jian'ri	1
拨云撩雨	bo'yun'liao'yu	1
伯仲之间	bo'zhong'zhi'jian	1
不安其室	bu'an'qi'shi	1
不安于室	bu'an'yu'shi	1
不安于位	bu'an'yu'wei	1
不拔之志	bu'ba'zhi'zhi	1
不白之冤	bu'bai'zhi'yuan	1
不卑不亢	bu'bei'bu'kang	1
布被瓦器	bu'bei'wa'qi	1
不避斧钺	bu'bi'fu'yue	1
不辨菽麦	bu'bian'shu'mai	1
不辨真伪	bu'bian'zhen'wei	1
布帛菽粟	bu'bo'shu'su	1
步步莲花	bu'bu'lian'hua	1
步步为营	bu'bu'wei'ying	1
不茶不饭	bu'cha'bu'fan	1
不差毫发	bu'cha'hao'fa	1
不差毫厘	bu'cha'hao'li	1
不差累黍	bu'cha'lei'shu	1
不臣之心	bu'chen'zhi'xin	1
不成三瓦	bu'cheng'san'wa	1
不成体统	bu'cheng'ti'tong	1
不逞之徒	bu'cheng'zhi'tu	1
不痴不聋	bu'chi'bu'long	1
不啻天渊	bu'chi'tian'yuan	1
不耻下问	bu'chi'xia'wen	1
不齿于人	bu'chi'yu'ren	1
不耻最后	bu'chi'zui'hou	1
不瞅不睬	bu'chou'bu'cai	1
不出所料	bu'chu'suo'liao	1
不揣冒昧	bu'chuai'mao'mei	1
不辞而别	bu'ci'er'bie	1
不辞劳苦	bu'ci'lao'ku	1
不次之迁	bu'ci'zhi'qian	1
不存芥蒂	bu'cun'jie'di	1
不打自招	bu'da'zi'zhao	1
不待蓍龟	bu'dai'shi'gui	1
不当人子	bu'dang'ren'zi	1
不得而知	bu'de'er'zhi	1
不得其所	bu'de'qi'suo	1
不得人心	bu'de'ren'xin	1
不得善终	bu'de'shan'zhong	1
不得要领	bu'de'yao'ling	1
步调一致	bu'diao'yi'zhi	1
不动声色	bu'dong'sheng'se	1
不恶而严	bu'e'er'yan	1
不二法门	bu'er'fa'men	1
不法常可	bu'fa'chang'ke	1
不乏其人	bu'fa'qi'ren	1
不乏先例	bu'fa'xian'li	1
布帆无恙	bu'fan'wu'yang	1
不悱不发	bu'fei'bu'fa	1
不废江河	bu'fei'jiang'he	1
不分彼此	bu'fen'bi'ci	1
不愤不启	bu'fen'bu'qi	1
不分轩轾	bu'fen'xuan'zhi	1
不分皂白	bu'fen'zao'bai	1
不分畛域	bu'fen'zhen'yu	1
不丰不杀	bu'feng'bu'sha	1
捕风捉影	bu'feng'zhuo'ying	1
不伏烧埋	bu'fu'shao'mai	1
不服水土	bu'fu'shui'tu	1
不负众望	bu'fu'zhong'wang	1
不改其乐	bu'gai'qi'le	1
不尴不尬	bu'gan'bu'ga	1
不甘雌伏	bu'gan'ci'fu	1
不敢告劳	bu'gan'gao'lao	1
不敢苟同	bu'gan'gou'tong	1
不甘后人	bu'gan'hou'ren	1
不甘寂寞	bu'gan'ji'mo	1
不敢掠美	bu'gan'lve'mei	1
不敢旁骛	bu'gan'pang'wu	1
不甘示弱	bu'gan'shi'ruo	1
不敢问津	bu'gan'wen'jin	1
不根之论	bu'gen'zhi'lun	1
不共戴天	bu'gong'dai'tian	1
不攻自破	bu'gong'zi'po	1
不苟言笑	bu'gou'yan'xiao	1
不古不今	bu'gu'bu'jin	1
布鼓雷门	bu'gu'lei'men	1
不管不顾	bu'guan'bu'gu	1
不关紧要	bu'guan'jin'yao	1
不关痛痒	bu'guan'tong'yang	1
不轨之徒	bu'gui'zhi'tu	1
不过尔尔	bu'guo'er'er	1
补过拾遗	bu'guo'shi'yi	1
不寒而栗	bu'han'er'li	1
不合时宜	bu'he'shi'yi	1
不哼不哈	bu'heng'bu'ha	1
不欢而散	bu'huan'er'san	1
不讳之门	bu'hui'zhi'men	1
不惑之年	bu'huo'zhi'nian	1
不即不离	bu'ji'bu'li	1
不疾不徐	bu'ji'bu'xu	1
不计其数	bu'ji'qi'shu	1
不羁之才	bu'ji'zhi'cai	1
不及之法	bu'ji'zhi'fa	1
不羁之民	bu'ji'zhi'min	1
不急之务	bu'ji'zhi'wu	1
不稼不穑	bu'jia'bu'se	1
不假思索	bu'jia'si'suo	1
不见经传	bu'jian'jing'zhuan	1
不见天日	bu'jian'tian'ri	1
不骄不躁	bu'jiao'bu'zao	1
不教而杀	bu'jiao'er'sha	1
不教而诛	bu'jiao'er'zhu	1
不教之教	bu'jiao'zhi'jiao	1
不解之缘	bu'jie'zhi'yuan	1
不矜不伐	bu'jin'bu'fa	1
不今不古	bu'jin'bu'gu	1
不近人情	bu'jin'ren'qing	1
不进则退	bu'jin'ze'tui	1
不胫而走	bu'jing'er'zou	1
不经之谈	bu'jing'zhi'tan	1
不咎既往	bu'jiu'ji'wang	1
补苴罅漏	bu'ju'xia'lou	1
不拘小节	bu'ju'xiao'jie	1
不拘一格	bu'ju'yi'ge	1
不觉技痒	bu'jue'ji'yang	1
不绝如缕	bu'jue'ru'lv	1
不绝于耳	bu'jue'yu'er	1
不堪回首	bu'kan'hui'shou	1
不堪其忧	bu'kan'qi'you	1
不堪入耳	bu'kan'ru'er	1
不堪入目	bu'kan'ru'mu	1
不堪设想	bu'kan'she'xiang	1
不堪言状	bu'kan'yan'zhuang	1
不堪一击	bu'kan'yi'ji	1
不堪造就	bu'kan'zao'jiu	1
不刊之论	bu'kan'zhi'lun	1
不亢不卑	bu'kang'bu'bei	1
不可动摇	bu'ke'dong'yao	1
不可端倪	bu'ke'duan'ni	1
不可多得	bu'ke'duo'de	1
不可告人	bu'ke'gao'ren	1
不可教训	bu'ke'jiao'xun	1
不可究诘	bu'ke'jiu'jie	1
不可救药	bu'ke'jiu'yao	1
不可开交	bu'ke'kai'jiao	1
不可揆度	bu'ke'kui'duo	1
不可理喻	bu'ke'li'yu	1
不可名状	bu'ke'ming'zhuang	1
不可磨灭	bu'ke'mo'mie	1
不可偏废	bu'ke'pian'fei	1
不可企及	bu'ke'qi'ji	1
不可胜数	bu'ke'sheng'shu	1
不可胜言	bu'ke'sheng'yan	1
不可收拾	bu'ke'shou'shi	1
不可思议	bu'ke'si'yi	1
不可限量	bu'ke'xian'liang	1
不可向迩	bu'ke'xiang'er	1
不可言宣	bu'ke'yan'xuan	1
不可言喻	bu'ke'yan'yu	1
不可言状	bu'ke'yan'zhuang	1
不可一世	bu'ke'yi'shi	1
不可移易	bu'ke'yi'yi	1
不可逾越	bu'ke'yu'yue	1
不可造次	bu'ke'zao'ci	1
不可终日	bu'ke'zhong'ri	1
不可捉摸	bu'ke'zhuo'mo	1
不愧不作	bu'kui'bu'zuo	1
不愧屋漏	bu'kui'wu'lou	1
不郎不秀	bu'lang'bu'xiu	1
不稂不莠	bu'lang'bu'you	1
不劳而获	bu'lao'er'huo	1
不立文字	bu'li'wen'zi	1
不了了之	bu'liao'liao'zhi	1
不劣方头	bu'lie'fang'tou	1
不吝赐教	bu'lin'ci'jiao	1
不吝指教	bu'lin'zhi'jiao	1
不吝珠玉	bu'lin'zhu'yu	1
不留余地	bu'liu'yu'di	1
不露锋芒	bu'lu'feng'mang	1
不露圭角	bu'lu'gui'jiao	1
不露声色	bu'lu'sheng'se	1
不伦不类	bu'lun'bu'lei	1
不落窠臼	bu'luo'ke'jiu	1
步履蹒跚	bu'lv'pan'shan	1
步履维艰	bu'lv'wei'jian	1
不蔓不枝	bu'man'bu'zhi	1
不毛之地	bu'mao'zhi'di	1
不明不白	bu'ming'bu'bai	1
不名一钱	bu'ming'yi'qian	1
不谋而合	bu'mou'er'he	1
不牧之地	bu'mu'zhi'di	1
不能自拔	bu'neng'zi'ba	1
不能自已	bu'neng'zi'yi	1
不念旧恶	bu'nian'jiu'e	1
不宁唯是	bu'ning'wei'shi	1
不偏不党	bu'pian'bu'dang	1
不偏不倚	bu'pian'bu'yi	1
补偏救弊	bu'pian'jiu'bi	1
不平则鸣	bu'ping'ze'ming	1
不破不立	bu'puo'bu'li	1
不欺暗室	bu'qi'an'shi	1
不弃草昧	bu'qi'cao'mei	1
不期而然	bu'qi'er'ran	1
不期而遇	bu'qi'er'yu	1
不期修古	bu'qi'xiu'gu	1
不擒二毛	bu'qin'er'mao	1
不情之请	bu'qing'zhi'qing	1
不求甚解	bu'qiu'shen'jie	1
不求闻达	bu'qiu'wen'da	1
不屈不挠	bu'qu'bu'nao	1
补阙灯檠	bu'que'deng'qing	1
补阙拾遗	bu'que'shi'yi	1
步人后尘	bu'ren'hou'chen	1
不忍卒读	bu'ren'zu'du	1
不日不月	bu'ri'bu'yue	1
不容置辩	bu'rong'zhi'bian	1
不容置喙	bu'rong'zhi'hui	1
不容置疑	bu'rong'zhi'yi	1
不如归去	bu'ru'gui'qu	1
不入时宜	bu'ru'shi'yi	1
不三不四	bu'san'bu'si	1
不衫不履	bu'shan'bu'lv	1
不上不下	bu'shang'bu'xia	1
不赏之功	bu'shang'zhi'gong	1
不舍昼夜	bu'she'zhou'ye	1
不甚了了	bu'shen'liao'liao	1
不胜杯杓	bu'sheng'bei'shao	1
不生不灭	bu'sheng'bu'mie	1
不胜枚举	bu'sheng'mei'ju	1
不胜其烦	bu'sheng'qi'fan	1
不胜其任	bu'sheng'qi'ren	1
不识不知	bu'shi'bu'zhi	1
不识大体	bu'shi'da'ti	1
不识高低	bu'shi'gao'di	1
不失圭撮	bu'shi'gui'cuo	1
不失毫厘	bu'shi'hao'li	1
不食马肝	bu'shi'ma'gan	1
不失时机	bu'shi'shi'ji	1
不识时务	bu'shi'shi'wu	1
不识抬举	bu'shi'tai'ju	1
不识泰山	bu'shi'tai'shan	1
不识一丁	bu'shi'yi'ding	1
不食之地	bu'shi'zhi'di	1
不世之功	bu'shi'zhi'gong	1
不识之无	bu'shi'zhi'wu	1
不时之需	bu'shi'zhi'xu	1
不食周粟	bu'shi'zhou'su	1
不死不活	bu'si'bu'huo	1
不速之客	bu'su'zhi'ke	1
逋逃之臣	bu'tao'zhi'chen	1
补天浴日	bu'tian'yu'ri	1
不腆之仪	bu'tian'zhi'yi	1
补天柱地	bu'tian'zhu'di	1
不祧之祖	bu'tiao'zhi'zu	1
不痛不痒	bu'tong'bu'yang	1
不同凡响	bu'tong'fan'xiang	1
不同流俗	bu'tong'liu'su	1
不通水火	bu'tong'shui'huo	1
不吐不茹	bu'tu'bu'ru	1
不忘沟壑	bu'wang'gou'he	1
不忘故旧	bu'wang'gu'jiu	1
不违农时	bu'wei'nong'shi	1
不为已甚	bu'wei'yi'shen	1
不闻不问	bu'wen'bu'wen	1
不文不武	bu'wen'bu'wu	1
不务空名	bu'wu'kong'ming	1
不无小补	bu'wu'xiao'bu	1
不务正业	bu'wu'zheng'ye	1
不舞之鹤	bu'wu'zhi'he	1
不惜工本	bu'xi'gong'ben	1
步线行针	bu'xian'xing'zhen	1
不相上下	bu'xiang'shang'xia	1
不相为谋	bu'xiang'wei'mou	1
不相闻问	bu'xiang'wen'wen	1
不祥之兆	bu'xiang'zhi'zhao	1
不肖子孙	bu'xiao'zi'sun	1
不屑一顾	bu'xie'yi'gu	1
不省人事	bu'xing'ren'shi	1
不修边幅	bu'xiu'bian'fu	1
不徐不疾	bu'xu'bu'ji	1
不恤人言	bu'xu'ren'yan	1
不学无术	bu'xue'wu'shu	1
不徇私情	bu'xun'si'qing	1
不言而信	bu'yan'er'xin	1
不言而喻	bu'yan'er'yu	1
不厌其烦	bu'yan'qi'fan	1
不厌其详	bu'yan'qi'xiang	1
卜夜卜昼	bu'ye'bu'zhou	1
不夷不惠	bu'yi'bu'hui	1
不依不饶	bu'yi'bu'rao	1
不翼而飞	bu'yi'er'fei	1
不一而足	bu'yi'er'zu	1
不亦乐乎	bu'yi'le'hu	1
布衣黔首	bu'yi'qian'shou	1
布衣蔬食	bu'yi'shu'shi	1
不以为耻	bu'yi'wei'chi	1
布衣韦带	bu'yi'wei'dai	1
不以为奇	bu'yi'wei'qi	1
不以为然	bu'yi'wei'ran	1
不以为意	bu'yi'wei'yi	1
不易一字	bu'yi'yi'zi	1
不遗余力	bu'yi'yu'li	1
不义之财	bu'yi'zhi'cai	1
不易之典	bu'yi'zhi'dian	1
布衣之交	bu'yi'zhi'jiao	1
不易之论	bu'yi'zhi'lun	1
不阴不阳	bu'yin'bu'yang	1
不饮盗泉	bu'yin'dao'quan	1
不因人热	bu'yin'ren're	1
不由分说	bu'you'fen'shuo	1
不由自主	bu'you'zi'zhu	1
不虞之誉	bu'yu'zhi'yu	1
不远千里	bu'yuan'qian'li	1
不远万里	bu'yuan'wan'li	1
不约而同	bu'yue'er'tong	1
不在话下	bu'zai'hua'xia	1
不赞一词	bu'zan'yi'ci	1
不择手段	bu'ze'shou'duan	1
不折不扣	bu'zhe'bu'kou	1
不正之风	bu'zheng'zhi'feng	1
不置褒贬	bu'zhi'bao'bian	1
不知不觉	bu'zhi'bu'jue	1
不忮不求	bu'zhi'bu'qiu	1
不知丁董	bu'zhi'ding'dong	1
不知端倪	bu'zhi'duan'ni	1
不知凡几	bu'zhi'fan'ji	1
不知甘苦	bu'zhi'gan'ku	1
不知高低	bu'zhi'gao'di	1
不知好歹	bu'zhi'hao'dai	1
不知纪极	bu'zhi'ji'ji	1
不栉进士	bu'zhi'jin'shi	1
不知进退	bu'zhi'jin'tui	1
不知就里	bu'zhi'jiu'li	1
不置可否	bu'zhi'ke'fou	1
不知利害	bu'zhi'li'hai	1
不知其详	bu'zhi'qi'xiang	1
不知轻重	bu'zhi'qing'zhong	1
不知去向	bu'zhi'qu'xiang	1
不知肉味	bu'zhi'rou'wei	1
不知深浅	bu'zhi'shen'qian	1
不知世务	bu'zhi'shi'wu	1
不知死活	bu'zhi'si'huo	1
不知所措	bu'zhi'suo'cuo	1
不知所以	bu'zhi'suo'yi	1
不知所云	bu'zhi'suo'yun	1
不知所终	bu'zhi'suo'zhong	1
不值一顾	bu'zhi'yi'gu	1
不值一钱	bu'zhi'yi'qian	1
不治之症	bu'zhi'zhi'zheng	1
卜昼卜夜	bu'zhou'bu'ye	1
不主故常	bu'zhu'gu'chang	1
不着边际	bu'zhuo'bian'ji	1
不自量力	bu'zi'liang'li	1
不足齿数	bu'zu'chi'shu	1
不足挂齿	bu'zu'gua'chi	1
不足介意	bu'zu'jie'yi	1
不足为据	bu'zu'wei'ju	1
不足为凭	bu'zu'wei'ping	1
不足为奇	bu'zu'wei'qi	1
不足为训	bu'zu'wei'xun	1
不足与谋	bu'zu'yu'mou	1
材大难用	cai'da'nan'yong	1
才德兼备	cai'de'jian'bei	1
才短思涩	cai'duan'si'se	1
彩凤随鸦	cai'feng'sui'ya	1
才高八斗	cai'gao'ba'dou	1
才高识远	cai'gao'shi'yuan	1
才高行厚	cai'gao'xing'hou	1
才高行洁	cai'gao'xing'jie	1
才高意广	cai'gao'yi'guang	1
才高运蹇	cai'gao'yun'jian	1
材高知深	cai'gao'zhi'shen	1
才华超众	cai'hua'chao'zhong	1
采及葑菲	cai'ji'feng'fei	1
才兼文武	cai'jian'wen'wu	1
采兰赠药	cai'lan'zeng'yao	1
才貌双全	cai'mao'shuang'quan	1
猜枚行令	cai'mei'xing'ling	1
材能兼备	cai'neng'jian'bei	1
才气过人	cai'qi'guo'ren	1
才气无双	cai'qi'wu'shuang	1
才识过人	cai'shi'guo'ren	1
才疏学浅	cai'shu'xue'qian	1
才疏意广	cai'shu'yi'guang	1
才疏志大	cai'shu'zhi'da	1
菜蔬之色	cai'shu'zhi'se	1
才望高雅	cai'wang'gao'ya	1
采薪之忧	cai'xin'zhi'you	1
彩衣娱亲	cai'yi'yu'qin	1
财运亨通	cai'yun'heng'tong	1
彩云易散	cai'yun'yi'san	1
才子佳人	cai'zi'jia'ren	1
残暴不仁	can'bao'bu'ren	1
残杯冷炙	can'bei'leng'zhi	1
残编断简	can'bian'duan'jian	1
残兵败将	can'bing'bai'jiang	1
惨不忍睹	can'bu'ren'du	1
惨不忍闻	can'bu'ren'wen	1
残茶剩饭	can'cha'sheng'fan	1
惨淡经营	can'dan'jing'ying	1
残冬腊月	can'dong'la'yue	1
餐风露宿	can'feng'lu'su	1
餐风沐雨	can'feng'mu'yu	1
惭凫企鹤	can'fu'qi'he	1
残膏剩馥	can'gao'sheng'fu	1
残羹冷炙	can'geng'leng'zhi	1
残花败柳	can'hua'bai'liu	1
粲花之论	can'hua'zhi'lun	1
蚕绩蟹匡	can'ji'xie'kuang	1
惨绝人寰	can'jue'ren'huan	1
灿烂辉煌	can'lan'hui'huang	1
惨绿少年	can'lv'shao'nian	1
残民害理	can'min'hai'li	1
残年暮景	can'nian'mu'jing	1
残年余力	can'nian'yu'li	1
残缺不全	can'que'bu'quan	1
灿若繁星	can'ruo'fan'xing	1
残山剩水	can'shan'sheng'shui	1
蚕食鲸吞	can'shi'jing'tun	1
参透机关	can'tou'ji'guan	1
蚕头燕尾	can'tou'yan'wei	1
惨无人道	can'wu'ren'dao	1
餐腥啄腐	can'xing'zhuo'fu	1
残渣余孽	can'zha'yu'nie	1
仓卒之际	cang'cu'zhi'ji	1
仓卒主人	cang'cu'zhu'ren	1
苍翠欲滴	cang'cui'yu'di	1
藏弓烹狗	cang'gong'peng'gou	1
藏垢纳污	cang'gou'na'wu	1
沧海横流	cang'hai'heng'liu	1
沧海桑田	cang'hai'sang'tian	1
沧海一粟	cang'hai'yi'su	1
沧海遗珠	cang'hai'yi'zhu	1
仓皇出逃	cang'huang'chu'tao	1
苍黄翻复	cang'huang'fan'fu	1
仓皇失措	cang'huang'shi'cuo	1
藏龙卧虎	cang'long'wo'hu	1
藏怒宿怨	cang'nu'su'yuan	1
藏器待时	cang'qi'dai'shi	1
藏巧于拙	cang'qiao'yu'zhuo	1
苍生涂炭	cang'sheng'tu'tan	1
苍松翠柏	cang'song'cui'bai	1
藏头露尾	cang'tou'lu'wei	1
藏污纳垢	cang'wu'na'gou	1
藏形匿影	cang'xing'ni'ying	1
苍颜白发	cang'yan'bai'fa	1
苍蝇见血	cang'ying'jian'xue	1
藏踪蹑迹	cang'zong'nie'ji	1
草草了事	cao'cao'liao'shi	1
草草收兵	cao'cao'shou'bing	1
草创未就	cao'chuang'wei'jiu	1
操刀必割	cao'dao'bi'ge	1
操刀伤锦	cao'dao'shang'jin	1
操翰成章	cao'han'cheng'zhang	1
草间求活	cao'jian'qiu'huo	1
草菅人命	cao'jian'ren'ming	1
草庐三顾	cao'lu'san'gu	1
草满囹圄	cao'man'ling'yu	1
草莽英雄	cao'mang'ying'xiong	1
草木皆兵	cao'mu'jie'bing	1
草木俱朽	cao'mu'ju'xiu	1
草木知威	cao'mu'zhi'wei	1
操奇计赢	cao'qi'ji'ying	1
草率从事	cao'shuai'cong'shi	1
草率收兵	cao'shuai'shou'bing	1
草薙禽狝	cao'ti'qin'xian	1
草头天子	cao'tou'tian'zi	1
草行露宿	cao'xing'lu'su	1
草长莺飞	cao'zhang'ying'fei	1
操之过急	cao'zhi'guo'ji	1
操纵自如	cao'zong'zi'ru	1
侧目而视	ce'mu'er'shi	1
厕身其间	ce'shen'qi'jian	1
恻隐之心	ce'yin'zhi'xin	1
侧足而立	ce'zu'er'li	1
厕足其间	ce'zu'qi'jian	1
参差不齐	cen'ci'bu'qi	1
参差错落	cen'ci'cuo'luo	1
层出不穷	ceng'chu'bu'qiong	1
曾几何时	ceng'ji'he'shi	1
层见叠出	ceng'jian'die'chu	1
曾经沧海	ceng'jing'cang'hai	1
层峦叠嶂	ceng'luan'die'zhang	1
察察为明	cha'cha'wei'ming	1
插翅难飞	cha'chi'nan'fei	1
插翅难逃	cha'chi'nan'tao	1
察己知人	cha'ji'zhi'ren	1
察见渊鱼	cha'jian'yuan'yu	1
察今知古	cha'jin'zhi'gu	1
插科打诨	cha'ke'da'hun	1
差强人意	cha'qiang'ren'yi	1
插圈弄套	cha'quan'nong'tao	1
差三错四	cha'san'cuo'si	1
查无实据	cha'wu'shi'ju	1
察言观色	cha'yan'guan'se	1
茶余饭后	cha'yu'fan'hou	1
茶余酒后	cha'yu'jiu'hou	1
搽脂抹粉	cha'zhi'mo'fen	1
姹紫嫣红	cha'zi'yan'hong	1
拆白道字	chai'bai'dao'zi	1
拆东补西	chai'dong'bu'xi	1
钗横鬓乱	chai'heng'bin'luan	1
柴毁骨立	chai'hui'gu'li	1
钗荆裙布	chai'jing'qun'bu	1
豺狼成性	chai'lang'cheng'xing	1
豺狼当道	chai'lang'dang'dao	1
豺狼之吻	chai'lang'zhi'wen	1
柴米夫妻	chai'mi'fu'qi	1
蝉不知雪	chan'bu'zhi'xue	1
蝉腹龟肠	chan'fu'gui'chang	1
蟾宫折桂	chan'gong'zhe'gui	1
铲迹销声	chan'ji'xiao'sheng	1
缠绵悱恻	chan'mian'fei'ce	1
冁然而笑	chan'ran'er'xiao	1
谄上欺下	chan'shang'qi'xia	1
馋涎欲滴	chan'xian'yu'di	1
长安道上	chang'an'dao'shang	1
长安棋局	chang'an'qi'ju	1
常备不懈	chang'bei'bu'xie	1
唱筹量沙	chang'chou'liang'sha	1
长此以往	chang'ci'yi'wang	1
尝胆卧薪	chang'dan'wo'xin	1
尝鼎一脔	chang'ding'yi'luan	1
唱对台戏	chang'dui'tai'xi	1
倡而不和	chang'er'bu'he	1
肠肥脑满	chang'fei'nao'man	1
长风破浪	chang'feng'po'lang	1
长歌当哭	chang'ge'dang'ku	1
苌弘化碧	chang'hong'hua'bi	1
惝恍迷离	chang'huang'mi'li	1
长江天堑	chang'jiang'tian'qian	1
长颈鸟喙	chang'jing'niao'hui	1
猖獗一时	chang'jue'yi'shi	1
长乐未央	chang'le'wei'yang	1
常鳞凡介	chang'lin'fan'jie	1
长林丰草	chang'lin'feng'cao	1
长虑顾后	chang'lv'gu'hou	1
长眠不起	chang'mian'bu'qi	1
长命百岁	chang'ming'bai'sui	1
长命富贵	chang'ming'fu'gui	1
长目飞耳	chang'mu'fei'er	1
长年累月	chang'nian'lei'yue	1
长辔远驭	chang'pei'yuan'yu	1
长篇大论	chang'pian'da'lun	1
长篇累牍	chang'pian'lei'du	1
长驱直入	chang'qu'zhi'ru	1
怅然若失	chang'ran'ruo'shi	1
长舌之妇	chang'she'zhi'fu	1
长生不老	chang'sheng'bu'lao	1
长生不死	chang'sheng'bu'si	1
长绳系日	chang'sheng'ji'ri	1
常胜将军	chang'sheng'jiang'jun	1
长生久视	chang'sheng'jiu'shi	1
畅所欲言	chang'suo'yu'yan	1
倡条冶叶	chang'tiao'ye'ye	1
长亭短亭	chang'ting'duan'ting	1
畅通无阻	chang'tong'wu'zu	1
长途跋涉	chang'tu'ba'she	1
长袖善舞	chang'xiu'shan'wu	1
长吁短叹	chang'xu'duan'tan	1
长夜难明	chang'ye'nan'ming	1
长夜之饮	chang'ye'zhi'yin	1
长揖不拜	chang'yi'bu'bai	1
长斋礼佛	chang'zhai'li'fo	1
长斋绣佛	chang'zhai'xiu'fo	1
长枕大被	chang'zhen'da'bei	1
长治久安	chang'zhi'jiu'an	1
超超玄著	chao'chao'xuan'zhu	1
超尘拔俗	chao'chen'ba'su	1
超度众生	chao'du'zhong'sheng	1
超凡出世	chao'fan'chu'shi	1
超凡入圣	chao'fan'ru'sheng	1
嘲风弄月	chao'feng'nong'yue	1
嘲风咏月	chao'feng'yong'yue	1
巢毁卵破	chao'hui'luan'po	1
巢居穴处	chao'ju'xue'chu	1
超群拔类	chao'qun'ba'lei	1
超群出众	chao'qun'chu'zhong	1
超群绝伦	chao'qun'jue'lun	1
超然物外	chao'ran'wu'wai	1
超然象外	chao'ran'xiang'wai	1
超然自得	chao'ran'zi'de	1
超然自逸	chao'ran'zi'yi	1
朝阳丹凤	chao'yang'dan'feng	1
超轶绝尘	chao'yi'jue'chen	1
超以象外	chao'yi'xiang'wai	1
车殆马烦	che'dai'ma'fan	1
掣襟露肘	che'jin'lu'zhou	1
车笠之盟	che'li'zhi'meng	1
车马盈门	che'ma'ying'men	1
扯篷拉纤	che'peng'la'qian	1
彻上彻下	che'shang'che'xia	1
车水马龙	che'shui'ma'long	1
彻头彻尾	che'tou'che'wei	1
车无退表	che'wu'tui'biao	1
车载斗量	che'zai'dou'liang	1
车在马前	che'zai'ma'qian	1
沈博绝丽	chen'bo'jue'li	1
沉博绝丽	chen'bo'jue'li	1
陈陈相因	chen'chen'xiang'yin	1
陈词滥调	chen'ci'lan'diao	1
尘饭涂羹	chen'fan'tu'geng	1
沉浮俯仰	chen'fu'fu'yang	1
尘垢秕糠	chen'gou'bi'kang	1
沉痼自若	chen'gu'zi'ruo	1
晨光熹微	chen'guang'xi'wei	1
陈规陋习	chen'gui'lou'xi	1
晨昏定省	chen'hun'ding'xing	1
趁火打劫	chen'huo'da'jie	1
称家有无	chen'jia'you'wu	1
沉静寡言	chen'jing'gua'yan	1
沉疴难起	chen'ke'nan'qi	1
沉李浮瓜	chen'li'fu'gua	1
陈力就列	chen'li'jiu'lie	1
臣门如市	chen'men'ru'shi	1
沉湎酒色	chen'mian'jiu'se	1
沉默寡言	chen'mo'gua'yan	1
瞋目切齿	chen'mu'qie'chi	1
沉潜刚克	chen'qian'gang'ke	1
趁热打铁	chen're'da'tie	1
趁人之危	chen'ren'zhi'wei	1
陈善闭邪	chen'shan'bi'xie	1
陈师鞠旅	chen'shi'ju'lv	1
趁势落篷	chen'shi'luo'peng	1
称体载衣	chen'ti'cai'yi	1
臣心如水	chen'xin'ru'shui	1
称心如意	chen'xin'ru'yi	1
晨兴夜寐	chen'xing'ye'mei	1
趁虚而入	chen'xu'er'ru	1
陈言务去	chen'yan'wu'qu	1
沉吟不决	chen'yin'bu'jue	1
沉吟章句	chen'yin'zhang'ju	1
沉郁顿挫	chen'yu'dun'cuo	1
沉鱼落雁	chen'yu'luo'yan	1
沉冤莫白	chen'yuan'mo'bai	1
沉灶产蛙	chen'zao'chan'wa	1
晨钟暮鼓	chen'zhong'mu'gu	1
沉滓泛起	chen'zi'fan'qi	1
成败得失	cheng'bai'de'shi	1
成败利钝	cheng'bai'li'dun	1
成败论人	cheng'bai'lun'ren	1
城北徐公	cheng'bei'xu'gong	1
秤不离砣	cheng'bu'li'tuo	1
撑肠拄腹	cheng'chang'zhu'fu	1
乘车戴笠	cheng'che'dai'li	1
称臣纳贡	cheng'chen'na'gong	1
称德度功	cheng'de'duo'gong	1
惩恶劝善	cheng'e'quan'shan	1
乘肥衣轻	cheng'fei'yi'qing	1
惩忿窒欲	cheng'fen'zhi'yu	1
乘风破浪	cheng'feng'po'lang	1
惩羹吹齑	cheng'geng'chui'ji	1
称孤道寡	cheng'gu'dao'gua	1
瞠乎其后	cheng'hu'qi'hou	1
城狐社鼠	cheng'hu'she'shu	1
承欢膝下	cheng'huan'xi'xia	1
诚惶诚恐	cheng'huang'cheng'kong	1
橙黄橘绿	cheng'huang'ju'lv	1
成己成物	cheng'ji'cheng'wu	1
成家立业	cheng'jia'li'yie	1
乘坚策肥	cheng'jian'ce'fei	1
乘坚驱良	cheng'jian'qu'liang	1
澄江如练	cheng'jiang'ru'lian	1
秤斤注两	cheng'jin'zhu'liang	1
乘龙佳婿	cheng'long'jia'xu	1
乘龙快婿	cheng'long'kuai'xu	1
成龙配套	cheng'long'pei'tao	1
乘鸾跨凤	cheng'luan'kua'feng	1
程门立雪	cheng'men'li'xue	1
瞠目结舌	cheng'mu'jie'she	1
成年累月	cheng'nian'lei'yue	1
秤平斗满	cheng'ping'dou'man	1
承平盛世	cheng'ping'sheng'shi	1
乘其不备	cheng'qi'bu'bei	1
惩前毖后	cheng'qian'bi'hou	1
承前启后	cheng'qian'qi'hou	1
成千上万	cheng'qian'shang'wan	1
成群结队	cheng'qun'jie'dui	1
成仁取义	cheng'ren'qu'yi	1
成人之美	cheng'ren'zhi'mei	1
乘人之危	cheng'ren'zhi'wei	1
承上启下	cheng'shang'qi'xia	1
成事不说	cheng'shi'bu'shuo	1
乘时乘势	cheng'shi'cheng'shi	1
成双作对	cheng'shuang'zuo'dui	1
成算在心	cheng'suan'zai'xin	1
承天之祐	cheng'tian'zhi'you	1
称王称霸	cheng'wang'cheng'ba	1
乘伪行诈	cheng'wei'xing'zha	1
乘隙而入	cheng'xi'er'ru	1
城下之盟	cheng'xia'zhi'meng	1
称贤荐能	cheng'xian'jian'neng	1
承先启后	cheng'xian'qi'hou	1
诚心诚意	cheng'xin'cheng'yi	1
秤薪而爨	cheng'xin'er'cuan	1
称薪而爨	cheng'xin'er'cuan	1
逞性妄为	cheng'xing'wang'wei	1
称兄道弟	cheng'xiong'dao'di	1
逞凶肆虐	cheng'xiong'si'nve	1
乘虚迭出	cheng'xu'die'chu	1
乘虚而入	cheng'xu'er'ru	1
承颜候色	cheng'yan'hou'se	1
成一家言	cheng'yi'jian'yan	1
惩一儆百	cheng'yi'jing'bai	1
称雨道晴	cheng'yu'dao'aing	1
成竹在胸	cheng'zhu'zai'xiong	1
齿白唇红	chi'bai'chun'hong	1
赤壁鏖兵	chi'bi'ao'bing	1
赤膊上阵	chi'bo'shang'zhen	1
尺布斗粟	chi'bu'dou'su	1
驰骋疆场	chi'cheng'jiang'chang	1
赤诚相待	chi'cheng'xiang'dai	1
持筹握算	chi'chou'wo'suan	1
踟蹰不前	chi'chu'bu'qian	1
尺椽片瓦	chi'chuan'pian'wa	1
吃穿用度	chi'chuan'yong'du	1
尺寸之功	chi'cu'zhi'gong	1
尺寸可取	chi'cun'ke'qu	1
尺寸之地	chi'cun'zhi'di	1
赤胆忠心	chi'dan'zhong'xin	1
赤地千里	chi'di'qian'li	1
尺短寸长	chi'duan'cu'chang	1
痴儿呆女	chi'er'dai'nv	1
尺幅千里	chi'fu'qian'li	1
持衡拥璇	chi'heng'yong'xuan	1
尺蠖求伸	chi'huo'qiu'shen	1
赤口毒舌	chi'kou'du'she	1
持蠡测海	chi'li'ce'hai	1
吃里爬外	chi'li'pa'wai	1
持禄养交	chi'lu'yang'jiao	1
魑魅魍魉	chi'mei'wang'liang	1
驰名中外	chi'ming'zhong'wai	1
鸱目虎吻	chi'mu'hu'wen	1
迟暮之年	chi'mu'zhi'nian	1
痴男怨女	chi'nan'yuan'nv	1
赤贫如洗	chi'pin'ru'xi	1
持平之论	chi'ping'zhi'lun	1
痴人说梦	chi'ren'shuo'meng	1
齿若编贝	chi'ruo'bian'bei	1
赤舌烧城	chi'she'shao'cheng	1
赤身露体	chi'shen'lu'ti	1
赤绳系足	chi'sheng'ji'zu	1
赤手空拳	chi'shou'kong'quan	1
尺树寸泓	chi'shu'cun'hong	1
尺水丈波	chi'shui'zhang'bo	1
齿亡舌存	chi'wang'she'cun	1
持危扶颠	chi'wei'fu'dian	1
赤县神州	chi'xian'shen'zhou	1
赤心报国	chi'xin'bao'guo	1
痴心妄想	chi'xin'wang'xiang	1
赤心相待	chi'xin'xiang'dai	1
齿牙春色	chi'ya'chun'se	1
鸱鸦嗜鼠	chi'ya'shi'shu	1
齿牙余论	chi'ya'yu'lun	1
持盈保泰	chi'ying'bao'tai	1
池鱼笼鸟	chi'yu'long'niao	1
池鱼之殃	chi'yu'zhi'yang	1
尺泽之鲵	chi'ze'zhi'ni	1
叱咤风云	chi'zha'feng'yun	1
持斋把素	chi'zhai'ba'su	1
嗤之以鼻	chi'zhi'yi'bi	1
持之以恒	chi'zhi'yi'heng	1
持之有故	chi'zhi'you'gu	1
吃着不尽	chi'zhuo'bu'jin	1
赤子之心	chi'zi'zhi'xin	1
虫臂鼠肝	chong'bi'shu'gan	1
重蹈覆辙	chong'dao'fu'zhe	1
重睹天日	chong'du'tian'ri	1
充耳不闻	chong'er'bu'wen	1
冲锋陷阵	chong'feng'xian'zhen	1
重规迭矩	chong'gui'die'ju	1
冲昏头脑	chong'hun'tou'nao	1
重见天日	chong'jian'tian'ri	1
冲口而出	chong'kou'er'chu	1
充类至尽	chong'lei'zhi'jin	1
重峦叠嶂	chong'luan'die'zhang	1
崇论闳议	chong'lun'hong'yi	1
充闾之庆	chong'lv'zhi'qing	1
重门击柝	chong'men'ji'tuo	1
宠辱不惊	chong'ru'bu'jing	1
宠辱皆忘	chong'ru'jie'wang	1
宠辱若惊	chong'ru'ruo'jing	1
虫沙猿鹤	chong'sha'yuan'he	1
崇山峻岭	chong'shan'jun'ling	1
重生父母	chong'sheng'fu'mu	1
重温旧梦	chong'wen'jiu'meng	1
重熙累洽	chong'xi'lei'qia	1
重岩叠障	chong'yan'die'zhang	1
虫鱼之学	chong'yu'zhi'xue	1
重整旗鼓	chong'zheng'qi'gu	1
臭不可当	chou'bu'ke'dang	1
臭不可闻	chou'bu'ke'wen	1
愁肠百结	chou'chang'bai'jie	1
愁肠寸断	chou'chang'cun'duan	1
愁肠九回	chou'chang'jiu'hui	1
抽抽搭搭	chou'chou'da'da	1
踌躇不前	chou'chu'bu'qian	1
踌躇满志	chou'chu'man'zhi	1
抽刀断水	chou'dao'duan'shui	1
愁多夜长	chou'duo'ye'chang	1
抽筋拔骨	chou'jin'ba'gu	1
丑类恶物	chou'lei'e'wu	1
愁眉不展	chou'mei'bu'zhan	1
愁眉苦脸	chou'mei'ku'lian	1
愁眉泪眼	chou'mei'lei'yan	1
愁眉锁眼	chou'mei'suo'yan	1
愁眉啼妆	chou'mei'ti'zhuang	1
臭名远扬	chou'ming'yuan'yang	1
臭名昭著	chou'ming'zhao'zhu	1
稠人广众	chou'ren'guang'zhong	1
稠人广座	chou'ren'guang'zuo	1
臭肉来蝇	chou'rou'lai'ying	1
丑声远播	chou'sheng'yuan'bo	1
抽丝剥茧	chou'si'bao'jian	1
丑态百出	chou'tai'bai'chu	1
抽薪止沸	chou'xin'zhi'fei	1
愁云惨雾	chou'yun'can'wu	1
除暴安良	chu'bao'an'liang	1
楚材晋用	chu'cai'jin'yong	1
除残去秽	chu'can'qu'hui	1
出尘不染	chu'chen'bu'ran	1
楚楚可怜	chu'chu'ke'lian	1
初出茅庐	chu'chu'mao'lu	1
除恶务尽	chu'e'wu'jin	1
出尔反尔	chu'er'fan'er	1
初发芙蓉	chu'fa'fu'rong	1
出凡入胜	chu'fan'ru'sheng	1
处高临深	chu'gao'lin'shen	1
楚弓楚得	chu'gong'chu'de	1
出谷迁乔	chu'gu'qian'qiao	1
出乖露丑	chu'guai'lu'chou	1
楚棺秦楼	chu'guan'qin'lou	1
出何典记	chu'he'dian'ji	1
触机便发	chu'ji'bian'fa	1
除奸革弊	chu'jian'ge'bi	1
出将入相	chu'jiang'ru'xiang	1
楚界汉河	chu'jie'han'he	1
触景生情	chu'jing'sheng'qing	1
除旧布新	chu'jiu'bu'xin	1
除旧更新	chu'jiu'geng'xin	1
杵臼之交	chu'jiu'zhi'jiao	1
出口成章	chu'kou'cheng'zhang	1
出口入耳	chu'kou'ru'er	1
出口伤人	chu'kou'shang'ren	1
出类拔萃	chu'lei'ba'cui	1
触类旁通	chu'lei'pang'tong	1
樗栎庸材	chu'li'yong'cai	1
初露锋芒	chu'lu'feng'mang	1
楚梦云雨	chu'meng'yun'yu	1
出没无常	chu'mo'wu'chang	1
出谋画策	chu'mou'hua'ce	1
触目皆是	chu'mu'jie'shi	1
怵目惊心	chu'mu'jing'xin	1
触目惊心	chu'mu'jing'xin	1
触目如故	chu'mu'ru'gu	1
触目恸心	chu'mu'tong'xin	1
触目兴叹	chu'mu'xing'tan	1
出其不意	chu'qi'bu'yi	1
出奇制胜	chu'qi'zhi'sheng	1
锄强扶弱	chu'qiang'fu'ruo	1
楚囚对泣	chu'qiu'dui'qi	1
刍荛之见	chu'rao'zhi'jian	1
出人头地	chu'ren'tou'di	1
出人意表	chu'ren'yi'biao	1
出入人罪	chu'ru'ren'zui	1
础润而雨	chu'run'er'yu	1
出山泉水	chu'shan'quan'shui	1
出神入化	chu'shen'ru'hua	1
出生入死	chu'sheng'ru'si	1
出师不利	chu'shi'bu'li	1
出世超凡	chu'shi'chao'fan	1
出手得卢	chu'shou'de'lu	1
出水芙蓉	chu'shui'fu'rong	1
处堂燕雀	chu'tang'yan'que	1
出头露面	chu'tou'lu'mian	1
出头之日	chu'tou'zhi'ri	1
楚尾吴头	chu'wei'wu'tou	1
触物兴怀	chu'wu'xing'huai	1
除邪惩恶	chu'xie'cheng'e	1
初写黄庭	chu'xie'huang'ting	1
处心积虑	chu'xin'ji'lv	1
出言不逊	chu'yan'bu'xun	1
出言成章	chu'yan'cheng'zhang	1
出言无状	chu'yan'wu'zhuang	1
出言有章	chu'yan'you'zhang	1
楚腰纤细	chu'yao'xian'xi	1
出以公心	chu'yi'gong'xin	1
处之泰然	chu'zhi'tai'ran	1
揣合逢迎	chuai'he'feng'ying	1
穿壁引光	chuan'bi'yin'guang	1
传道受业	chuan'dao'shou'ye	1
舛讹百出	chuan'e'bai'chu	1
穿房入户	chuan'fang'ru'hu	1
穿井得人	chuan'jing'de'ren	1
川流不息	chuan'liu'bu'xi	1
串亲访友	chuan'qin'fang'you	1
传神阿堵	chuan'shen'e'du	1
传诵一时	chuan'song'yi'shi	1
串通一气	chuan'tong'yi'qi	1
传为笑柄	chuan'wei'xiao'bing	1
传闻异辞	chuan'wen'yi'ci	1
传檄而定	chuan'xi'er'ding	1
喘息之间	chuan'xi'zhi'jian	1
川壅必溃	chuan'yong'bi'kui	1
穿窬之盗	chuan'yu'zhi'dao	1
穿云裂石	chuan'yun'lie'shi	1
穿凿附会	chuan'zao'fu'hui	1
穿针引线	chuan'zhen'yin'xian	1
传宗接代	chuan'zong'jie'dai	1
闯荡江湖	chuang'dang'jiang'hu	1
怆地呼天	chuang'di'hu'tian	1
床笫之私	chuang'di'zhi'si	1
创巨痛深	chuang'ju'tong'shen	1
窗明几净	chuang'ming'ji'jing	1
床上安床	chuang'shang'an'chuang	1
床头金尽	chuang'tou'jin'jin	1
床下牛斗	chuang'xia'niu'dou	1
创业垂统	chuang'ye'chui'tong	1
创业维艰	chuang'ye'wei'jian	1
疮痍满目	chuang'yi'man'mu	1
吹唇唱吼	chui'chun'chang'hou	1
吹大法螺	chui'da'fa'luo	1
垂范百世	chui'fan'bai'shi	1
垂拱而治	chui'gong'er'zhi	1
吹灰之力	chui'hui'zhi'li	1
吹角连营	chui'jiao'lian'ying	1
炊金馔玉	chui'jin'zhuan'yu	1
吹糠见米	chui'kang'jian'mi	1
垂帘听政	chui'lian'ting'zheng	1
吹毛利刃	chui'mao'li'ren	1
吹毛求疵	chui'mao'qiu'ci	1
垂名青史	chui'ming'qing'shi	1
垂暮之年	chui'mu'zhi'nian	1
椎牛飨士	chui'niu'xiang'shi	1
吹气胜兰	chui'qi'sheng'lan	1
炊沙成饭	chui'sha'cheng'fan	1
垂手可得	chui'shou'ke'de	1
垂手而得	chui'shou'ke'de	1
垂死挣扎	chui'si'zheng'zha	1
吹弹得破	chui'tan'de'po	1
吹弹歌舞	chui'tan'ge'wu	1
垂头丧气	chui'tou'sang'qi	1
垂涎三尺	chui'xian'san'chi	1
垂涎欲滴	chui'xian'yu'di	1
吹箫乞食	chui'xiao'qi'shi	1
椎心泣血	chui'xin'li'xue	1
捶胸顿足	chui'xiong'dun'zu	1
吹影镂尘	chui'ying'lou'chen	1
春冰虎尾	chun'bing'hu'wei	1
唇不离腮	chun'bu'li'sai	1
唇齿相依	chun'chi'xiang'yi	1
唇齿之邦	chun'chi'zhi'bang	1
蠢蠢欲动	chun'chun'yu'dong	1
春风得意	chun'feng'de'yi	1
春风风人	chun'feng'feng'ren	1
春风和气	chun'feng'he'qi	1
春风化雨	chun'feng'hua'yu	1
春风满面	chun'feng'man'mian	1
春风夏雨	chun'feng'xia'yu	1
春风一度	chun'feng'yi'du	1
春风沂水	chun'feng'yi'shui	1
唇干口燥	chun'gan'kou'zao	1
莼羹鲈脍	chun'geng'lu'kuai	1
春光漏泄	chun'guang'lou'xie	1
春光明媚	chun'guang'ming'mei	1
春寒料峭	chun'han'liao'qiao	1
春和景明	chun'he'jing'ming	1
唇红齿白	chun'hong'chi'bai	1
春华秋实	chun'hua'qiu'shi	1
春花秋月	chun'hua'qiu'yue	1
春晖寸草	chun'hui'cun'cao	1
春回大地	chun'hui'da'di	1
唇焦舌敝	chun'jiao'she'bi	1
醇酒妇人	chun'jiu'fu'ren	1
鹑居鷇食	chun'ju'kou'shi	1
春兰秋菊	chun'lan'qiu'ju	1
春露秋霜	chun'lu'qiu'shuang	1
莼鲈之思	chun'lu'zhi'si	1
春梦无痕	chun'meng'wu'hen	1
春暖花开	chun'nuan'hua'kai	1
春葩丽藻	chun'pa'li'zao	1
唇枪舌剑	chun'qiang'she'jian	1
春秋笔法	chun'qiu'bi'fa	1
春秋鼎盛	chun'qiu'ding'sheng	1
春色撩人	chun'se'liao'ren	1
春色满园	chun'se'man'yuan	1
春山如笑	chun'shan'ru'xiao	1
春深似海	chun'shen'si'hai	1
春生秋杀	chun'sheng'qiu'sha	1
春树暮云	chun'shu'mu'yun	1
春诵夏弦	chun'song'xia'xian	1
春笋怒发	chun'sun'mu'fa	1
春蛙秋蝉	chun'wa'qiu'chan	1
唇亡齿寒	chun'wang'chi'han	1
春宵一刻	chun'xiao'yi'ke	1
椿萱并茂	chun'xuan'bing'mao	1
春意盎然	chun'yi'ang'ran	1
鹑衣百结	chun'yi'bai'jie	1
春意阑珊	chun'yi'lan'shan	1
春蚓秋蛇	chun'yin'qiu'she	1
春雨如油	chun'yu'ru'you	1
纯正无邪	chun'zheng'wu'xie	1
绰绰有余	chuo'chuo'you'yu	1
惙怛伤悴	chuo'da'shang'cui	1
踔绝之能	chuo'jue'zhi'neng	1
踔厉风发	chuo'li'feng'fa	1
啜食吐哺	chuo'shi'tu'bu	1
啜菽饮水	chuo'shu'yin'shui	1
绰有余裕	chuo'you'yu'yu	1
绰约多姿	chuo'yue'duo'zi	1
慈悲为本	ci'bei'wei'ben	1
辞不达意	ci'bu'da'yi	1
词不逮理	ci'bu'dai'li	1
此唱彼和	ci'chang'bi'he	1
刺刺不休	ci'ci'bu'xiu	1
词钝意虚	ci'dun'yi'xu	1
辞多受少	ci'duo'shou'shao	1
此伏彼起	ci'fu'bi'qi	1
辞富居贫	ci'fu'ju'pin	1
刺股读书	ci'gu'du'shu	1
刺股悬梁	ci'gu'xuan'liang	1
此恨绵绵	ci'hen'mian'mian	1
慈眉善目	ci'mei'shan'mu	1
慈明无双	ci'ming'wu'shuang	1
此起彼伏	ci'qi'bi'fu	1
此起彼落	ci'qi'bi'luo	1
赐墙及肩	ci'qiang'ji'jian	1
词穷理极	ci'qiong'li'ji	1
慈乌返哺	ci'wu'fan'bu	1
雌雄未决	ci'xiong'wei'jue	1
辞严义正	ci'yan'yi'zheng	1
此中三昧	ci'zhong'san'mei	1
辞尊居卑	ci'zun'ju'bei	1
从长计议	cong'chang'ji'yi	1
从恶是崩	cong'e'shi'beng	1
从谏如流	cong'jian'ru'liu	1
从井救人	cong'jing'jiu'ren	1
从宽发落	cong'kuan'fa'luo	1
从令如流	cong'ling'ru'liu	1
聪明才智	cong'ming'cai'zhi	1
聪明伶俐	cong'ming'ling'li	1
聪明一世	cong'ming'yi'shi	1
聪明正直	cong'ming'zheng'zhi	1
聪明智慧	cong'ming'zhi'hui	1
从容不迫	cong'rong'bu'po	1
从容就义	cong'rong'jiu'yi	1
从容应对	cong'rong'ying'dui	1
从善如流	cong'shan'ru'liu	1
从俗就简	cong'su'jiu'jia	1
从天而降	cong'tian'er'jiang	1
从天而下	cong'tian'er'xia	1
从心所欲	cong'xin'suo'yu	1
从一而终	cong'yi'er'zhong	1
从中渔利	cong'zhong'yu'li	1
从中作梗	cong'zhong'zuo'geng	1
猝不及防	cu'bu'ji'fang	1
粗茶淡饭	cu'cha'dan'fan	1
粗服乱头	cu'fu'luan'tou	1
醋海翻波	cu'hai'fan'bo	1
踧踖不安	cu'ji'bu'an	1
粗通文墨	cu'tong'wen'mo	1
促膝谈心	cu'xi'tan'xin	1
粗心大意	cu'xin'da'yi	1
粗心浮气	cu'xin'fu'qi	1
粗衣淡饭	cu'yi'dan'fan	1
粗衣粝食	cu'yi'li'shi	1
粗枝大叶	cu'zhi'da'ye	1
粗制滥造	cu'zhi'lan'zao	1
粗中有细	cu'zhong'you'xi	1
窜端匿迹	cuan'duan'ni'ji	1
蹿房越脊	cuan'fang'yue'ji	1
攒眉蹙额	cuan'mei'cu'e	1
攒三聚五	cuan'san'ju'wu	1
篡位夺权	cuan'wei'duo'quan	1
璀璨夺目	cui'can'duo'mu	1
摧锋陷阵	cui'feng'xian'zhen	1
摧刚为柔	cui'gang'wei'rou	1
摧坚陷阵	cui'jian'xian'zhen	1
摧枯拉朽	cui'ku'la'xiu	1
摧枯折腐	cui'ku'zhe'fu	1
摧兰折玉	cui'lan'zhe'yu	1
摧眉折腰	cui'mei'zhe'yao	1
翠绕珠围	cui'rao'zhu'wei	1
催人泪下	cui'ren'lei'xia	1
摧身碎首	cui'shen'sui'shou	1
摧陷廓清	cui'xian'kuo'qing	1
翠消红减	cui'xiao'hong'jian	1
摧心剖肝	cui'xin'pou'gan	1
摧折豪强	cui'zhe'hao'qiang	1
翠竹黄花	cui'zhu'huang'hua	1
寸步不离	cun'bu'bu'li	1
寸步不让	cun'bu'bu'rang	1
寸步难行	cun'bu'nan'xing	1
寸步千里	cun'bu'qian'li	1
寸草不留	cun'cao'bu'liu	1
寸草不生	cun'cao'bu'sheng	1
寸草春晖	cun'cao'chun'hui	1
寸地尺天	cun'di'chi'tian	1
存而不论	cun'er'bu'lun	1
村夫俗子	cun'fu'su'zi	1
村夫野老	cun'fu'ye'lao	1
寸进尺退	cun'jin'chi'tui	1
寸利必得	cun'li'bi'de	1
寸量铢称	cun'liang'zhu'cheng	1
寸木岑楼	cun'mu'cen'lou	1
寸男尺女	cun'nan'chi'nv	1
寸丝半粟	cun'si'ban'su	1
寸丝不挂	cun'si'bu'gua	1
寸田尺宅	cun'tian'chi'zhai	1
寸铁杀人	cun'tie'sha'ren	1
寸铁在手	cun'tie'zai'shou	1
寸土必争	cun'tu'bi'zheng	1
寸土不让	cun'tu'bu'rang	1
寸土尺地	cun'tu'chi'di	1
存亡安危	cun'wang'an'wei	1
存亡继绝	cun'wang'ji'jue	1
存亡绝续	cun'wang'jue'xu	1
存亡未卜	cun'wang'wei'bu	1
寸心千古	cun'xin'qian'gu	1
存心养性	cun'xin'yang'xing	1
村野匹夫	cun'ye'pi'fu	1
寸阴尺璧	cun'yin'chi'bi	1
寸阴若岁	cun'yin'ruo'sui	1
寸阴是惜	cun'yin'shi'xi	1
寸有所长	cun'you'suo'chang	1
寸指测渊	cun'zhi'ce'yuan	1
错彩镂金	cuo'cai'lou'jin	1
撮土焚香	cuo'gu'fen'xiang	1
厝火积薪	cuo'huo'ji'xin	1
错落不齐	cuo'luo'bu'qi	1
错落有致	cuo'luo'you'zhi	1
错认颜标	cuo'ren'yan'biao	1
措手不及	cuo'shou'bu'ji	1
搓手顿脚	cuo'shou'dun'jiao	1
蹉跎日月	cuo'tuo'ri'yue	1
蹉跎岁月	cuo'tuo'sui'yue	1
蹉跎自误	cuo'tuo'zi'wu	1
撮盐入火	cuo'yan'ru'huo	1
措置裕如	cuo'zhi'yu'ru	1
错综复杂	cuo'zong'fu'za	1
大败亏输	da'bai'kui'shu	1
打抱不平	da'bao'bu'ping	1
大本大宗	da'ben'da'zong	1
大笔如椽	da'bi'ru'chuan	1
大辩不言	da'bian'bu'yan	1
大辩若讷	da'bian'ruo'ne	1
大步流星	da'bu'liu'xing	1
大才槃槃	da'cai'pan'pan	1
大材小用	da'cai'xiao'yong	1
打草惊蛇	da'cao'jing'she	1
大彻大悟	da'che'da'wu	1
大澈大悟	da'che'da'wu	1
大车以载	da'che'yi'zai	1
打成一片	da'cheng'yi'pian	1
大处落墨	da'chu'luo'mo	1
大处着墨	da'chu'zhuo'mo	1
大处着眼	da'chu'zhuo'yan	1
大吹大擂	da'chui'da'lei	1
大吹法螺	da'chui'fa'luo	1
大醇小疵	da'chun'xiao'ci	1
大慈大悲	da'ci'da'bei	1
大错特错	da'cuo'te'cuo	1
大打出手	da'da'chu'shou	1
大大落落	da'da'luo'luo	1
大开大合	da'dai'da'he	1
大开眼界	da'dai'yan'jie	1
大刀阔斧	da'dao'kuo'fu	1
打得火热	da'de'huo're	1
大得人心	da'de'ren'xin	1
大敌当前	da'di'dang'qian	1
大地回春	da'di'hui'chun	1
大动干戈	da'dong'gan'ge	1
大度包容	da'du'bao'rong	1
大而化之	da'er'hua'zhi	1
大而无当	da'er'wu'dang	1
大发慈悲	da'fa'ci'bei	1
大发雷霆	da'fa'lei'ting	1
大法小廉	da'fa'xiao'lian	1
大放悲声	da'fang'bei'sheng	1
大放厥词	da'fang'jue'ci	1
大方之家	da'fang'zhi'jia	1
答非所问	da'fei'suo'wen	1
大风大浪	da'feng'da'lang	1
打凤捞龙	da'feng'lao'long	1
打富济贫	da'fu'ji'pin	1
大腹便便	da'fu'pian'pian	1
大功告成	da'gong'gao'cheng	1
大公无私	da'gong'wu'si	1
打躬作揖	da'gong'zuo'yi	1
打狗看主	da'gou'kan'zhu	1
达官贵人	da'guan'gui'ren	1
达官显宦	da'guan'xian'huan	1
达官知命	da'guan'zhi'ming	1
大海捞针	da'hai'lao'zhen	1
大寒索裘	da'han'suo'qiu	1
大含细入	da'han'xi'ru	1
大旱云霓	da'han'yun'ni	1
大行大市	da'hang'da'shi	1
大好河山	da'hao'he'shan	1
大惑不解	da'huo'bu'jie	1
大获全胜	da'huo'quan'sheng	1
大吉大利	da'ji'da'li	1
大计小用	da'ji'xiao'yong	1
大家风范	da'jia'feng'fan	1
大家闺秀	da'jia'gui'xiu	1
打家劫舍	da'jia'jie'she	1
大江东去	da'jiang'dong'qu	1
大江南北	da'jiang'nan'bei	1
大节不夺	da'jie'bu'duo	1
大街小巷	da'jie'xiao'xiang	1
大明法度	da'jing'fa'du	1
大惊失色	da'jing'shi'se	1
大惊小怪	da'jing'xiao'guai	1
大快人心	da'kuai'ren'xin	1
大块文章	da'kuai'wen'zhang	1
大浪淘沙	da'lang'tao'sha	1
大辂椎轮	da'lu'zhui'lun	1
打落水狗	da'luo'shui'gou	1
打马虎眼	da'ma'hu'yan	1
打闷葫芦	da'men'hu'lu	1
大梦初醒	da'meng'chu'xing	1
大名鼎鼎	da'ming'ding'ding	1
大谬不然	da'miu'bu'ran	1
大模大样	da'mo'da'yang	1
大莫与京	da'mo'yu'jing	1
大谋不谋	da'mou'bu'mou	1
大难不死	da'nan'bu'si	1
大难临头	da'nan'lin'tou	1
大逆不道	da'ni'bu'dao	1
大气磅礴	da'qi'pang'bo	1
大器晚成	da'qi'wan'cheng	1
大千世界	da'qian'shi'jie	1
大巧若拙	da'qiao'ruo'zhuo	1
打情骂俏	da'qing'ma'qiao	1
大权独揽	da'quan'du'lan	1
大权旁落	da'quan'pang'luo	1
大权在握	da'quan'zai'wo	1
达权知变	da'quan'zhi'bian	1
怛然失色	da'ran'shi'se	1
大仁大义	da'ren'da'yi	1
大人虎变	da'ren'hu'bian	1
达人知命	da'ren'zhi'ming	1
大厦栋梁	da'sha'dong'liang	1
大煞风景	da'sha'feng'jing	1
大厦将倾	da'sha'jiang'qing	1
大声疾呼	da'sheng'ji'hu	1
大是大非	da'shi'da'fei	1
大事铺张	da'shi'pu'zhang	1
大事去矣	da'shi'qu'yi	1
大失人望	da'shi'ren'wang	1
大势所趋	da'shi'suo'qu	1
大失所望	da'shi'suo'wang	1
大势已去	da'shi'yi'qu	1
大手大脚	da'shou'da'jiao	1
大树将军	da'shu'jiang'jun	1
大书特书	da'shu'te'shu	1
大肆厥辞	da'si'jue'ci	1
大题小作	da'ti'xiao'zuo	1
大天白日	da'tian'bai'ri	1
打铁趁热	da'tie'chen're	1
大庭广众	da'ting'guang'zhong	1
大同小异	da'tong'xiao'yi	1
大头小尾	da'tou'xiao'wei	1
打退堂鼓	da'tui'tang'gu	1
大喜过望	da'xi'guo'wang	1
大贤虎变	da'xian'hu'bian	1
大显身手	da'xian'shen'shou	1
大显神通	da'xian'shen'tong	1
大相径庭	da'xiang'jing'ting	1
大兴土木	da'xing'tu'mu	1
打牙犯嘴	da'ya'fan'zui	1
打牙配嘴	da'ya'pei'zui	1
大言不惭	da'yan'bu'can	1
大摇大摆	da'yao'da'bai	1
大义凛然	da'yi'lin'ran	1
大义灭亲	da'yi'mie'qin	1
大有裨益	da'you'bi'yi	1
大有径庭	da'you'jing'ting	1
大有可观	da'you'ke'guan	1
大有可为	da'you'ke'wei	1
大有起色	da'you'qi'se	1
大有人在	da'you'ren'zai	1
大有作为	da'you'zuo'wei	1
大展经纶	da'zhan'jing'lun	1
大张其词	da'zhang'qi'ci	1
大张旗鼓	da'zhang'qi'gu	1
大张声势	da'zhang'sheng'shi	1
大张挞伐	da'zhang'ta'fa	1
大杖则走	da'zhang'ze'zou	1
大政方针	da'zheng'fang'zhen	1
大智若愚	da'zhi'ruo'yu	1
大中至正	da'zhong'zhi'zheng	1
代拆代行	dai'chai'dai'xing	1
代代相传	dai'dai'xiang'chuan	1
怠惰因循	dai'duo'yin'xun	1
待价而沽	dai'jia'er'gu	1
带金佩紫	dai'jin'pei'zi	1
待理不理	dai'li'bu'li	1
戴笠乘车	dai'li'cheng'che	1
呆里撒奸	dai'li'sa'jian	1
带砺山河	dai'li'shan'he	1
带牛佩犊	dai'niu'pei'du	1
戴盆望天	dai'pen'wang'tian	1
待人接物	dai'ren'jie'wu	1
代人受过	dai'ren'shou'guo	1
代人捉刀	dai'ren'zhuo'dao	1
呆若木鸡	dai'ruo'mu'ji	1
待时而动	dai'shi'er'dong	1
待时守分	dai'shi'shou'fen	1
戴天履地	dai'tian'lv'di	1
呆头呆脑	dai'tou'dai'nao	1
戴头识脸	dai'tou'shi'lian	1
殆无孑遗	dai'wu'jie'yi	1
殆无虚日	dai'wu'xu'ri	1
戴圆履方	dai'yuan'lv'fang	1
戴月披星	dai'yue'pi'xing	1
待字闺中	dai'zi'gui'zhong	1
戴罪立功	dai'zui'li'gong	1
单兵孤城	dan'bing'gu'cheng	1
澹泊寡欲	dan'bo'gua'yu	1
淡泊明志	dan'bo'ming'zhi	1
殚财竭力	dan'cai'jie'li	1
胆粗气壮	dan'cu'qi'zhuang	1
胆大包天	dan'da'bao'tian	1
胆大如斗	dan'da'ru'dou	1
胆大妄为	dan'da'wang'wei	1
胆大心粗	dan'da'xin'cu	1
胆大心细	dan'da'xin'xi	1
胆大心小	dan'da'xin'xiao	1
旦旦而伐	dan'dan'er'fa	1
单刀赴会	dan'dao'fu'hui	1
单刀直入	dan'dao'zhi'ru	1
箪豆见色	dan'dou'jian'se	1
淡而不厌	dan'er'bu'yan	1
淡而无味	dan'er'wu'wei	1
丹凤朝阳	dan'feng'chao'yang	1
惮赫千里	dan'he'qian'li	1
单鹄寡凫	dan'hu'gua'fu	1
殚见洽闻	dan'jian'qia'wen	1
弹尽粮绝	dan'jin'liang'jue	1
弹尽援绝	dan'jin'yuan'jue	1
殚精毕力	dan'jing'bi'li	1
殚精竭虑	dan'jing'jie'lv	1
担惊受怕	dan'jing'shou'pa	1
胆裂魂飞	dan'lie'hun'fei	1
箪瓢屡空	dan'piao'lv'kong	1
胆破心寒	dan'po'xin'han	1
单枪匹马	dan'qiang'pi'ma	1
丹青不渝	dan'qing'bu'yu	1
淡然处之	dan'ran'chu'zhi	1
淡然置之	dan'ran'zhi'zhi	1
丹书铁契	dan'shu'tie'qi	1
丹书铁券	dan'shu'tie'quan	1
淡水交情	dan'shui'jiao'qing	1
箪食壶浆	dan'si'hu'jiang	1
箪食壶酒	dan'si'hu'jiu	1
殚思极虑	dan'si'ji'lv	1
箪食瓢饮	dan'si'piao'yin	1
弹丸之地	dan'wan'zhi'di	1
弹无虚发	dan'wu'xu'fa	1
旦夕之间	dan'xi'zhi'jian	1
旦夕之危	dan'xi'zhi'wei	1
胆小怕事	dan'xiao'pa'shi	1
胆小如鼠	dan'xiao'ru'shu	1
丹心碧血	dan'xin'bi'xue	1
丹心如故	dan'xin'ru'gu	1
担雪塞井	dan'xue'sai'jing	1
啖以重利	dan'yi'zhong'li	1
丹楹刻桷	dan'ying'ke'jue	1
胆战心寒	dan'zhan'xin'han	1
胆战心惊	dan'zhan'xin'jing	1
殚智竭力	dan'zhi'jie'li	1
旦种暮成	dan'zhong'mu'cheng	1
淡汝浓抹	dan'zhuang'nong'mo	1
党豺为虐	dang'chai'wei'nve	1
当场出彩	dang'chang'chu'cai	1
当断不断	dang'duan'bu'duan	1
当耳边风	dang'er'bian'feng	1
当风秉烛	dang'feng'bing'zhu	1
当行出色	dang'hang'chu'se	1
当机立断	dang'ji'li'duan	1
荡检逾闲	dang'jian'yu'xian	1
当立之年	dang'li'zhi'nian	1
当门抵户	dang'men'di'hu	1
荡气回肠	dang'qi'hui'chang	1
荡然无存	dang'ran'wu'cun	1
当仁不让	dang'ren'bu'rang	1
当世无双	dang'shi'wu'shuang	1
党同伐异	dang'tong'fa'yi	1
当头棒喝	dang'tou'bang'he	1
当头对面	dang'tou'dui'mian	1
当头一棒	dang'tou'yi'bang	1
当务之急	dang'wu'zhi'ji	1
荡析离居	dang'xi'li'ju	1
谠言直声	dang'yan'zhi'sheng	1
当之无愧	dang'zhi'wu'kui	1
当之有愧	dang'zhi'you'kui	1
当轴处中	dang'zhou'chu'zhong	1
当着不着	dang'zhuo'bu'zhuo	1
道傍之筑	dao'bang'zhi'zhu	1
倒背如流	dao'bei'ru'liu	1
倒绷孩儿	dao'beng'hai'er	1
道边苦李	dao'bian'ku'li	1
道不拾遗	dao'bu'shi'yi	1
倒裳索领	dao'chang'suo'ling	1
蹈常袭故	dao'chang'xi'gu	1
倒持泰阿	dao'chi'tai'e	1
道存目击	dao'cun'mu'ji	1
道大莫容	dao'da'mo'rong	1
倒打一耙	dao'da'yi'pa	1
道德文章	dao'de'wen'zhang	1
道而不径	dao'er'bu'jing	1
倒凤颠鸾	dao'feng'dian'luan	1
倒戈卸甲	dao'ge'xie'jia	1
刀耕火耨	dao'geng'huo'nou	1
刀耕火种	dao'geng'huo'zhong	1
倒冠落佩	dao'guan'luo'pei	1
刀光剑影	dao'guang'jian'ying	1
倒果为因	dao'guo'wei'yin	1
刀过竹解	dao'guo'zhu'jie	1
倒海翻江	dao'hai'fan'jiang	1
蹈节死义	dao'jie'si'yi	1
道尽涂殚	dao'jin'tu'dan	1
道尽途穷	dao'jin'tu'qiong	1
道殣相望	dao'jin'xiang'wang	1
刀锯鼎镬	dao'ju'ding'huo	1
刀锯斧钺	dao'ju'fu'yue	1
蹈厉奋发	dao'li'fen'fa	1
蹈厉之志	dao'li'zhi'zhi	1
道路以目	dao'lu'yi'mu	1
道貌岸然	dao'mao'an'ran	1
盗名暗世	dao'ming'an'shi	1
盗名欺世	dao'ming'qi'shi	1
道旁苦李	dao'pang'ku'li	1
蹈其覆辙	dao'qi'fu'zhe	1
刀枪剑戟	dao'qiang'jian'ji	1
蹈人旧辙	dao'ren'jiu'zhe	1
倒三颠四	dao'san'dian'si	1
刀山火海	dao'shan'huo'hai	1
刀山剑树	dao'shan'jian'shu	1
倒山倾海	dao'shan'qing'hai	1
道山学海	dao'shan'xue'hai	1
岛瘦郊寒	dao'shou'jiao'han	1
道听途说	dao'ting'tu'shuo	1
刀头舔蜜	dao'tou'tian'mi	1
蹈袭覆辙	dao'xi'fu'zhe	1
倒屣相迎	dao'xi'xiang'ying	1
悼心失图	dao'xin'shi'tu	1
倒行逆施	dao'xing'ni'shi	1
倒悬之急	dao'xuan'zhi'ji	1
倒悬之危	dao'xuan'zhi'wei	1
盗亦有道	dao'yi'you'dao	1
道义之交	dao'yi'zhi'jiao	1
道远日暮	dao'yuan'ri'mu	1
倒载干戈	dao'zai'gan'ge	1
盗憎主人	dao'zeng'zhu'ren	1
倒置干戈	dao'zhi'gan'ge	1
盗跖之物	dao'zhi'zhi'wu	1
盗钟掩耳	dao'zhong'yan'er	1
德薄才疏	de'bo'cai'shu	1
德薄能鲜	de'bo'neng'xian	1
得不偿失	de'bu'chang'shi	1
得步进步	de'bu'jin'bu	1
德才兼备	de'cai'jian'bei	1
得寸进尺	de'cun'jin'chi	1
得寸则寸	de'cun'ze'cun	1
灯蛾扑火	de'e'pu'huo	1
得而复失	de'er'fu'shi	1
德高望重	de'gao'wang'zhong	1
得过且过	de'guo'qie'guo	1
德厚流光	de'hou'liu'guang	1
得陇望蜀	de'long'wang'shu	1
得其三昧	de'qi'san'mei	1
得其所哉	de'qi'suo'zai	1
得胜回朝	de'sheng'hui'chao	1
得胜头回	de'sheng'tou'hui	1
得失参半	de'shi'can'ban	1
得失成败	de'shi'cheng'bai	1
得天独厚	de'tian'du'hou	1
得未曾有	de'wei'ceng'you	1
得心应手	de'xin'ying'shou	1
得婿如龙	de'xu'ru'long	1
德言容功	de'yan'rong'gong	1
得意门生	de'yi'men'sheng	1
德艺双馨	de'yi'shuang'xin	1
得意忘形	de'yi'wang'xing	1
得意忘言	de'yi'wang'yan	1
得意洋洋	de'yi'yang'yang	1
得意之色	de'yi'zhi'se	1
得意之作	de'yi'zhi'zuo	1
德音莫违	de'yin'mo'wei	1
得鱼忘筌	de'yu'wang'quan	1
得月较先	de'yue'jiao'xian	1
德重恩弘	de'zhong'en'hong	1
等而上之	deng'er'shang'zhi	1
等而下之	deng'er'xia'zhi	1
登峰造极	deng'feng'zao'ji	1
登高能赋	deng'gao'neng'fu	1
登高望远	deng'gao'wang'yuan	1
登高一呼	deng'gao'yi'hu	1
登高自卑	deng'gao'zi'bei	1
灯红酒绿	deng'hong'jiu'lv	1
灯火辉煌	deng'huo'hui'huang	1
等价连城	deng'jia'lian'cheng	1
等量齐观	deng'liang'qi'guan	1
等米下锅	deng'mi'xia'guo	1
登木求鱼	deng'mu'qiu'yu	1
登山临水	deng'shan'lin'shui	1
登山小鲁	deng'shan'xiao'lu	1
登坛拜将	deng'tan'bai'jiang	1
登堂入室	deng'tang'ru'shi	1
等闲视之	deng'xian'shi'zhi	1
等因奉此	deng'yin'feng'ci	1
灯烛辉煌	deng'zhu'hui'huang	1
抵背扼喉	di'bei'e'hou	1
地崩山摧	di'beng'shan'cui	1
砥兵砺伍	di'bing'li'wu	1
低唱浅斟	di'chang'qian'zhen	1
地坼天崩	di'che'tian'beng	1
地丑德齐	di'chou'de'qi	1
地大物博	di'da'wu'bo	1
地动山摇	di'dong'shen'yao	1
滴粉搓酥	di'fen'cuo'su	1
涤故更新	di'gu'geng'xin	1
地广人稀	di'guang'ren'xi	1
低回不已	di'hui'bu'yi	1
地角天涯	di'jiao'tian'ya	1
砥节奉公	di'jie'feng'gong	1
地久天长	di'jiu'tian'chang	1
敌忾同仇	di'kai'tong'chou	1
地旷人稀	di'kuang'ren'xi	1
堤溃蚁孔	di'kui'yi'kong	1
堤溃蚁穴	di'kui'yi'xue	1
地老天荒	di'lao'tian'huang	1
砥砺风节	di'li'feng'jie	1
地利人和	di'li'ren'he	1
砥砺琢磨	di'li'zhuo'mo	1
低眉垂眼	di'mei'chui'yan	1
低眉顺眼	di'mei'shun'yan	1
低眉折腰	di'mei'zhe'yao	1
地平天成	di'ping'tian'cheng	1
低三下四	di'san'xia'si	1
地上天官	di'shang'tian'guan	1
低声下气	di'sheng'xia'qi	1
低首下心	di'shou'xia'xin	1
滴水不漏	di'shui'bu'lou	1
滴水成冰	di'shui'cheng'bing	1
滴水穿石	di'shui'chuan'shi	1
抵死谩生	di'si'man'sheng	1
帝王将相	di'wang'jion'xiang	1
涤瑕荡秽	di'xia'dang'hui	1
抵瑕蹈隙	di'xia'dao'xi	1
地下修文	di'xia'xiu'wen	1
砥行立名	di'xing'li'ming	1
砥行磨名	di'xing'mo'ming	1
羝羊触藩	di'yang'chu'fan	1
低吟浅唱	di'yin'qian'chang	1
地狱变相	di'yu'bian'xiang	1
抵掌而谈	di'zhang'er'tan	1
地主之谊	di'zhu'zhi'yi	1
砥柱中流	di'zhu'zhong'liu	1
抵足而眠	di'zu'er'mian	1
颠倒黑白	dian'dao'hei'bai	1
颠倒乾坤	dian'dao'qian'kun	1
颠倒是非	dian'dao'shi'fei	1
颠倒衣裳	dian'dao'yi'chang	1
颠倒阴阳	dian'dao'yin'yang	1
电光石火	dian'guang'shi'huo	1
电光朝露	dian'guang'zhao'lu	1
掂斤播两	dian'jin'bo'liang	1
点金成铁	dian'jin'cheng'tie	1
点金乏术	dian'jin'fa'shu	1
点睛之笔	dian'jing'zhi'bi	1
颠来倒去	dian'lai'dao'qu	1
颠鸾倒凤	dian'luan'dao'feng	1
颠毛种种	dian'mao'zhong'zhong	1
颠沛流离	dian'pei'liu'li	1
颠扑不破	dian'pu'bu'po	1
典妻鬻子	dian'qi'yu'zi	1
颠乾倒坤	dian'qian'dao'kun	1
颠三倒四	dian'san'dao'si	1
电闪雷鸣	dian'shan'lei'ming	1
点石成金	dian'shi'cheng'jin	1
点铁成金	dian'tie'cheng'jin	1
点头哈腰	dian'tou'ha'yao	1
阽危之域	dian'wei'zhi'yu	1
簟纹如水	dian'wen'ru'shui	1
典章文物	dian'zhang'wen'wu	1
掉臂不顾	diao'bi'bu'gu	1
调兵遣将	diao'bing'qian'jiang	1
貂蝉满座	diao'chan'man'zuo	1
雕虫小技	diao'chong'xiao'ji	1
刁斗森严	diao'dou'sen'yan	1
吊尔郎当	diao'er'lang'dang	1
雕肝琢肾	diao'gan'zhuo'shen	1
吊古伤今	diao'gu'shang'jin	1
吊古寻幽	diao'gu'xun'you	1
雕蚶镂蛤	diao'han'lou'ge	1
调虎离山	diao'hu'li'shan	1
刁滑奸诈	diao'hua'jian'zha	1
雕阑玉砌	diao'lan'yu'qi	1
雕梁画栋	diao'liang'hua'dong	1
吊民伐罪	diao'min'fa'zui	1
钓名欺世	diao'ming'qi'shi	1
貂裘换酒	diao'qiu'huan'jiu	1
掉三寸舌	diao'san'cun'she	1
掉舌鼓唇	diao'she'gu'chun	1
吊死问疾	diao'si'wen'ji	1
刁天决地	diao'tian'jue'di	1
掉头鼠窜	diao'tou'shu'cuan	1
雕心雁爪	diao'xin'yan'zhao	1
掉以轻心	diao'yi'qing'xin	1
钓游之地	diao'you'zhi'di	1
钓名沽誉	diao'yu'gu'ming	1
雕玉双联	diao'yu'shuang'lian	1
雕章镂句	diao'zhang'lou'ju	1
刁钻古怪	diao'zuan'gu'guai	1
刁钻刻薄	diao'zuan'ke'bo	1
叠床架屋	die'chuang'jia'wu	1
迭床架屋	die'chuang'jia'wu	1
喋喋不休	die'die'bu'xiu	1
蝶粉蜂黄	die'fen'feng'huang	1
鼎铛有耳	ding'cheng'you'er	1
鼎铛玉石	ding'cheng'yu'shi	1
鼎鼎大名	ding'ding'da'ming	1
丁公凿井	ding'gong'zao'jing	1
定国安邦	ding'guo'an'bang	1
鼎镬刀锯	ding'huo'dao'ju	1
鼎镬如饴	ding'huo'ru'yi	1
顶礼膜拜	ding'li'mo'bai	1
定倾扶危	ding'qing'fu'wei	1
顶天立地	ding'tian'li'di	1
鼎新革故	ding'xin'ge'gu	1
丁一卯二	ding'yi'mao'er	1
丁一确二	ding'yi'que'er	1
鼎鱼幕燕	ding'yu'mu'yan	1
定于一尊	ding'yu'yi'zun	1
顶针续麻	ding'zhen'xu'ma	1
鼎足而三	ding'zu'er'san	1
鼎足三分	ding'zu'san'fen	1
鼎足之势	ding'zu'zhi'shi	1
钉嘴铁舌	ding'zui'tie'she	1
丢盔卸甲	diu'kui'xie'jia	1
丢三落四	diu'san'la'si	1
丢卒保车	diu'zu'bao'ju	1
东奔西走	dong'ben'xi'zou	1
动不失时	dong'bu'shi'shi	1
洞察其奸	dong'cha'qi'jian	1
洞察秋毫	dong'cha'qiu'hao	1
洞察一切	dong'cha'yi'qie	1
洞彻事理	dong'che'shi'li	1
东床快婿	dong'chuang'kuai'xu	1
东窗事发	dong'chuang'shi'fa	1
东床坦腹	dong'chuang'tan'fu	1
东倒西歪	dong'dao'xi'wai	1
东道之谊	dong'dao'zhi'yi	1
洞房花烛	dong'fang'hua'zhu	1
东方千骑	dong'fang'qian'ji	1
东风浩荡	dong'feng'hao'dang	1
东风化雨	dong'feng'hua'yu	1
东风人面	dong'feng'ren'mian	1
东扶西倒	dong'fu'xi'dao	1
东观续史	dong'guan'xu'shi	1
东郭先生	dong'guo'xian'sheng	1
东海捞针	dong'hai'lao'zhen	1
东海扬尘	dong'hai'yang'chen	1
冬烘先生	dong'hong'xian'sheng	1
董狐直笔	dong'hu'zhi'bi	1
洞鉴废兴	dong'jian'fei'xing	1
东箭南金	dong'jian'nan'jin	1
洞见症结	dong'jian'zheng'jie	1
冻解冰释	dong'jie'bing'shi	1
动静有常	dong'jing'you'chang	1
东拉西扯	dong'la'xi'che	1
东劳西燕	dong'lao'xi'yan	1
栋梁之材	dong'liang'zhi'cai	1
东鳞西爪	dong'lin'xi'zhao	1
东南半壁	dong'nan'ban'bi	1
东南雀飞	dong'nan'que'fei	1
东怒西怨	dong'nu'xi'yuan	1
东跑西颠	dong'pao'xi'dian	1
动魄惊心	dong'po'jing'xin	1
东墙处子	dong'qiang'chu'zi	1
冬裘夏葛	dong'qiu'xia'ge	1
动人心魄	dong'ren'xin'po	1
动人心弦	dong'ren'xin'xian	1
冬日可爱	dong'ri'ke'ai	1
冬日夏云	dong'ri'xia'yun	1
动如脱兔	dong'ru'tuo'tu	1
洞若观火	dong'ruo'guan'huo	1
东山高卧	dong'shan'gao'wo	1
冬扇夏炉	dong'shan'xia'lu	1
东山再起	dong'shan'zai'qi	1
东食西宿	dong'shi'xi'su	1
东施效颦	dong'shi'xiao'pin	1
洞天福地	dong'tian'fu'di	1
东涂西抹	dong'tu'xi'mo	1
东兔西乌	dong'tu'xi'wu	1
冬温夏凊	dong'wen'xia'jing	1
东西南北	dong'xi'nan'bei	1
动心怵目	dong'xin'chu'mu	1
动心骇目	dong'xin'hai'mu	1
动心忍性	dong'xin'ren'xing	1
东摇西摆	dong'yao'xi'bai	1
东野巴人	dong'ye'ba'ren	1
恫疑虚喝	dong'yi'xu'he	1
洞幽烛微	dong'you'zhu'wei	1
东张西望	dong'zhang'xi'wang	1
栋折榱崩	dong'zhe'cui'beng	1
动辄得咎	dong'zhe'de'jiu	1
东征西讨	dong'zheng'xi'tao	1
动之以情	dong'zhi'yi'qing	1
洞烛其奸	dong'zhu'qi'jian	1
东走西顾	dong'zou'xi'gu	1
豆重榆瞑	dou'chong'yu'ming	1
兜肚连肠	dou'du'lian'chang	1
斗而铸锥	dou'er'zhu'zhui	1
斗方名士	dou'fang'ming'shi	1
斗鸡走狗	dou'ji'zou'gou	1
斗酒百篇	dou'jiu'bai'pian	1
斗酒学士	dou'jiu'xue'shi	1
斗酒只鸡	dou'jiu'zhi'ji	1
豆蔻年华	dou'kou'nian'hua	1
斗南一人	dou'nan'yi'ren	1
豆剖瓜分	dou'pou'gua'fen	1
斗筲之器	dou'shao'zhi'qi	1
斗升之水	dou'sheng'zhi'shui	1
抖擞精神	dou'sou'jing'shen	1
斗粟尺布	dou'su'chi'bu	1
斗榫合缝	dou'sun'he'feng	1
斗折蛇行	dou'zhe'she'xing	1
斗志昂扬	dou'zhi'ang'yang	1
斗转参横	dou'zhuan'shen'heng	1
斗转星移	dou'zhuan'xing'yi	1
独清独醒	duu'qing'du'xing	1
独霸一方	du'ba'yi'fang	1
独步当时	du'bu'dang'shi	1
独步天下	du'bu'tian'xia	1
独步一时	du'bu'yi'shi	1
独出己见	du'chu'ji'jian	1
独出机杼	du'chu'ji'zhu	1
独出心裁	du'chu'xi'cai	1
独当一面	du'dang'yi'mian	1
独到之处	du'dao'zhi'chu	1
独得之见	du'de'zhi'jian	1
独断独行	du'duan'du'xing	1
独断专行	du'duan'zhuan'xing	1
笃而论之	du'er'lun'zhi	1
独夫民贼	du'fu'min'zei	1
蠹国害民	du'guo'hai'min	1
独鹤鸡群	du'he'ji'qun	1
独茧抽丝	du'jian'chou'si	1
杜渐防萌	du'jian'fang'meng	1
杜渐防微	du'jian'fang'wei	1
笃近举远	du'jin'ju'juan	1
睹景伤情	du'jing'shang'qing	1
独具匠心	du'ju'jiang'xin	1
蠹居棋处	du'ju'qi'chu	1
独具只眼	du'ju'zhi'yan	1
杜鹃啼血	du'juan'ti'xue	1
杜绝后患	du'jue'hou'huan	1
杜绝人事	du'jue'ren'shi	1
杜绝言路	du'jue'yan'lu	1
杜口裹足	du'kou'guo'zu	1
杜口吞声	du'kou'tun'sheng	1
独揽大权	du'lan'da'quan	1
肚里泪下	du'li'lei'xia	1
独立自主	du'li'zi'zhu	1
杜门晦迹	du'men'hui'ji	1
杜门绝迹	du'men'jue'ji	1
杜门却扫	du'men'que'sao	1
杜门谢客	du'men'xie'ke	1
杜门自绝	du'men'zi'jue	1
杜门自守	du'men'zi'shou	1
独木难支	du'mu'nan'zhi	1
妒能害贤	du'neng'hai'xian	1
独辟蹊径	du'pi'xi'jing	1
度日如年	du'ri'ru'nian	1
独善其身	du'shan'qi'shen	1
独是独非	du'shi'du'fei	1
笃实好学	du'shi'hao'xue	1
毒手尊前	du'shou'zun'qian	1
读书得间	du'shu'de'jian	1
读书三到	du'shu'san'dao	1
读书三余	du'shu'san'yu	1
独树一帜	du'shu'yi'zhi	1
读书种子	du'shu'zhong'zi	1
都头异姓	du'tou'yi'xing	1
度外之人	du'wai'zhi'ren	1
独往独来	du'wang'du'lai	1
杜微慎防	du'wei'shen'fang	1
睹微知著	du'wei'zhi'zhu	1
睹物思人	du'wu'si'ren	1
睹物兴情	du'wu'xing'qing	1
杜隙防微	du'xi'fang'wei	1
妒贤嫉能	du'xian'ji'neng	1
笃信好学	du'xin'hao'xue	1
独行其道	du'xing'qi'dao	1
独行其是	du'xing'qi'shi	1
笃学不倦	du'xue'bu'juan	1
独学寡闻	du'xue'gua'wen	1
笃学好古	du'xue'hao'gu	1
独一无二	du'yi'wu'er	1
独异于人	du'yi'yu'ren	1
独有千秋	du'you'qian'qiu	1
独占鳌头	du'zhan'ao'tou	1
蠹众木折	du'zhong'mu'zhe	1
独坐愁城	du'zuo'chou'cheng	1
端本正源	duan'ben'zheng'yuan	1
断壁残璋	duan'bi'can'zhang	1
断壁颓垣	duan'bi'tui'yuan	1
断编残简	duan'bian'can'jian	1
短兵相接	duan'bing'xiang'jie	1
断长续短	duan'chang'xu'duan	1
断脰决腹	duan'dou'jue'fu	1
断发文身	duan'fa'wen'shen	1
断根绝种	duan'gen'jue'zhong	1
短绠汲深	duan'geng'ji'shen	1
断梗飘蓬	duan'geng'piao'peng	1
短褐不完	duan'he'bu'wan	1
短褐穿结	duan'he'chuan'jie	1
断鹤续凫	duan'he'xu'fu	1
断还归宗	duan'huan'gui'zong	1
断齑画粥	duan'ji'hua'zhou	1
短见薄识	duan'jian'bo'shi	1
断简残编	duan'jian'can'bian	1
断井颓垣	duan'jing'tui'yuan	1
断决如流	duan'jue'ru'liu	1
断烂朝报	duan'lan'chao'bao	1
断墨残楮	duan'mo'can'chu	1
端倪可察	duan'ni'ke'cha	1
断手续玉	duan'shou'xu'yu	1
断头将军	duan'tou'jiang'jun	1
断无此理	duan'wu'ci'li	1
断线风筝	duan'xian'feng'zheng	1
断线偶戏	duan'xian'ou'xi	1
短小精悍	duan'xiao'jing'han	1
断袖之癖	duan'xiu'zhi'pi	1
断雁孤鸿	duan'yan'gu'hong	1
短衣匹马	duan'yi'pi'ma	1
断垣残壁	duan'yuan'can'bi	1
短垣自逾	duan'yuan'zi'yu	1
断章取义	duan'zhang'qu'yi	1
断章摘句	duan'zhang'zhai'ju	1
断织劝学	duan'zhi'quan'xue	1
断织之诫	duan'zhi'zhi'jie	1
断杼择邻	duan'zhu'ze'lin	1
堆案盈几	dui'an'ying'ji	1
对簿公堂	dui'bu'gong'tang	1
对床夜雨	dui'chuang'ye'yu	1
对答如流	dui'da'ru'liu	1
堆积如山	dui'ji'ru'shan	1
堆金叠玉	dui'jin'die'yu	1
堆金积玉	dui'jin'ji'yu	1
对景挂画	dui'jing'gua'hua	1
对景伤情	dui'jing'shang'qing	1
对酒当歌	dui'jiu'dang'ge	1
对牛弹琴	dui'niu'tan'qin	1
堆山积海	dui'shan'ji'hai	1
对头冤家	dui'tou'yuan'jia	1
对症下药	dui'zheng'xia'yao	1
对症之药	dui'zheng'zhi'yao	1
遁迹潜形	dun'ji'qian'xing	1
顿开茅塞	dun'kai'mao'se	1
顿口无言	dun'kou'wu'yan	1
顿口拙腮	dun'kou'zhuo'sai	1
遁名匿迹	dun'ming'ni'ji	1
遁入空门	dun'ru'kong'men	1
敦诗说礼	dun'shi'shuo'li	1
顿首再拜	dun'shou'zai'bai	1
顿学累功	dun'xue'lei'gong	1
顿足不前	dun'zu'bu'qian	1
顿足捶胸	dun'zu'chui'xiong	1
多才多艺	duo'cai'duo'yi	1
多财善贾	duo'cai'shan'gu	1
多藏厚亡	duo'cang'hou'wang	1
多愁多病	duo'chou'duo'bing	1
多愁善感	duo'chou'shan'gan	1
多此一举	duo'ci'yi'ju	1
度德量力	duo'de'liang'li	1
多端寡要	duo'duan'guai'yao	1
咄咄逼人	duo'duo'bi'ren	1
咄咄怪事	duo'duo'guai'shi	1
多多益善	duo'duo'yi'shan	1
多故之秋	duo'gu'zhi'qiu	1
度己以绳	duo'ji'yi'sheng	1
咄嗟便办	duo'jie'bian'ban	1
咄嗟叱咤	duo'jie'chi'zha	1
咄嗟立办	duo'jie'li'ban	1
掇菁撷华	duo'jing'xie'hua	1
多口阿师	duo'kou'a'shi	1
多快好省	duo'kuai'hao'sheng	1
多历年所	duo'li'nian'suo	1
夺门而出	duo'men'er'chu	1
多谋善断	duo'mou'shan'duan	1
多谋善虑	duo'mou'shan'lv	1
多难兴邦	duo'nan'xing'bang	1
夺其谈经	duo'qi'tan'jing	1
多歧亡羊	duo'qi'wang'yang	1
多情善感	duo'qing'shan'gan	1
夺人所好	duo'ren'suo'hao	1
多如牛毛	duo'ru'niu'mao	1
掇拾章句	duo'shi'zhang'ju	1
多事之秋	duo'shi'zhi'qiu	1
夺胎换骨	duo'tai'huan'gu	1
掇臀捧屁	duo'tun'peng'pi	1
多文为富	duo'wen'wei'fu	1
多许少与	duo'xu'shao'yu	1
朵颐大嚼	duo'yi'da'jiao	1
堕云雾中	duo'yun'wu'zhong	1
堕甑不顾	duo'zeng'bu'gu	1
恶叉白赖	e'cha'bai'lai	1
阿党相为	e'dang'xiang'wei	1
遏恶扬善	e'e'yan'shan	1
扼吭夺食	e'gang'duo'shi	1
扼吭拊背	e'gang'fu'bei	1
峨冠博带	e'guan'bo'dai	1
恶贯满盈	e'guan'man'ying	1
扼喉抚背	e'hou'fu'bei	1
饿虎饥鹰	e'hu'ji'ying	1
饿虎扑食	e'hu'pu'shi	1
饿虎扑羊	e'hu'pu'yang	1
饿虎之蹊	e'hu'zhi'xi	1
恶积祸盈	e'ji'huo'ying	1
恶迹昭著	e'ji'zhao'zhu	1
鹅毛大雪	e'mao'da'xue	1
蛾眉皓齿	e'mei'hao'chi	1
婀娜多姿	e'nuo'duo'zi	1
饿莩遍野	e'piao'bian'ye	1
饿殍满道	e'piao'man'dao	1
阿其所好	e'qi'suo'hao	1
恶声恶气	e'sheng'e'qi	1
阿时趋俗	e'shi'qu'su	1
额手称庆	e'shou'cheng'qing	1
扼腕长叹	e'wan'chang'tan	1
恶性循环	e'xing'xun'huan	1
鹅行鸭步	e'xing'ya'bu	1
讹言惑众	e'yan'huo'zhong	1
恶衣恶食	e'yi'e'shi	1
恶衣粝食	e'yi'li'shi	1
恶有恶报	e'you'e'bao	1
阿谀谄媚	e'yu'chan'mei	1
阿谀奉承	e'yu'feng'cheng	1
阿谀逢迎	e'yu'feng'ying	1
阿谀取容	e'yu'qu'rong	1
恶语伤人	e'yu'shang'ren	1
恶语相加	e'yu'xiang'jia	1
恶语中伤	e'yu'zhong'shang	1
恩德如山	en'de'ru'shan	1
思断义绝	en'duan'yi'jue	1
恩恩相报	en'en'xiang'bao	1
恩将仇报	en'jiang'chou'bao	1
恩荣并济	en'rong'bing'ji	1
恩若再生	en'ruo'zai'sheng	1
恩山义海	en'shan'yi'hai	1
恩深义重	en'shen'yi'zhong	1
恩甚怨生	en'shen'yuan'sheng	1
恩同父母	en'tong'fu'mu	1
恩同再造	en'tong'zai'zao	1
恩威并行	en'wei'bing'xing	1
恩威并重	en'wei'bing'zhong	1
恩有重报	en'you'zhong'bao	1
恩逾慈母	en'yu'ci'mu	1
恩怨分明	en'yuan'fen'ming	1
恩重如山	en'zhong'ru'shan	1
恩重泰山	en'zhong'tai'shan	1
二八佳人	er'ba'jia'ren	1
耳鬓斯磨	er'bin'si'mo	1
耳聪目明	er'cong'mu'ming	1
二分明月	er'fen'ming'yue	1
耳根清净	er'gen'qing'jing	1
耳红面赤	er'hong'mian'chi	1
耳后生风	er'hou'sheng'feng	1
二惠竞爽	er'hui'jing'shuang	1
而立之年	er'li'zhi'nian	1
二龙戏珠	er'long'xi'zhu	1
耳目股肱	er'mu'gu'gong	1
耳目一新	er'mu'yi'xin	1
耳目昭彰	er'mu'zhao'zhang	1
儿女成行	er'nv'cheng'hang	1
儿女情长	er'nv'qing'chang	1
儿女心肠	er'nv'xin'chang	1
耳濡目染	er'ru'mu'ran	1
耳软心活	er'ruan'xin'huo	1
二三其德	er'san'qi'de	1
二三其意	er'san'qi'yi	1
耳视目听	er'shi'mu'ting	1
耳食之谈	er'shi'zhi'tan	1
耳熟能详	er'shu'neng'xiang	1
二竖为虐	er'shu'wei'nve	1
耳提面命	er'ti'mian'ming	1
耳听八方	er'ting'ba'fang	1
耳听心受	er'ting'xin'shou	1
耳闻目睹	er'wen'mu'du	1
耳闻目击	er'wen'mu'ji	1
耳闻目见	er'wen'mu'jian	1
耳闻则诵	er'wen'ze'song	1
二心两意	er'xin'liang'yi	1
二姓之好	er'xing'zhi'hao	1
尔虞我诈	er'yu'wo'zha	1
尔诈我虞	er'zha'wo'yu	1
罚不当罪	fa'bu'dang'zui	1
法不阿贵	fa'bu'e'gui	1
法不徇情	fa'bu'xun'qing	1
罚不责众	fa'bu'ze'zhong	1
发策决科	fa'ce'jue'ke	1
发短心长	fa'duan'xin'chang	1
发凡起例	fa'fan'qi'li	1
发愤图强	fa'fen'tu'qiang	1
发愤忘食	fa'fen'wang'shi	1
伐功矜能	fa'gong'jin'neng	1
法海无边	fa'hai'wu'bian	1
发号施令	fa'hao'shi'ling	1
法家拂士	fa'jia'bi'shi	1
发奸擿伏	fa'jian'ti'fu	1
法力无边	fa'li'wu'bian	1
发聋振聩	fa'long'zhen'kui	1
法轮常转	fa'lun'chang'zhuan	1
伐毛洗髓	fa'mao'xi'sui	1
发蒙解惑	fa'meng'jie'huo	1
发蒙振聩	fa'meng'zhen'kui	1
发蒙振落	fa'meng'zhen'luo	1
发人深思	fa'ren'shen'si	1
发人深省	fa'ren'shen'xing	1
发棠之请	fa'tang'zhi'qing	1
发秃齿豁	fa'tu'chi'huo	1
法外施仁	fa'wai'shi'ren	1
发硎新试	fa'xing'xin'shi	1
伐性之斧	fa'xing'zhi'fu	1
发言盈庭	fa'yan'ying'ting	1
发扬踔厉	fa'yang'chuo'li	1
发扬蹈厉	fa'yang'dao'li	1
发扬光大	fa'yang'guang'da	1
罚一劝百	fa'yi'quan'bai	1
发引千钧	fa'yin'qian'jun	1
发政施仁	fa'zheng'shi'ren	1
发指眦裂	fa'zhi'zi'lie	1
发综指示	fa'zong'zhi'shi	1
反败为胜	fan'bai'wei'sheng	1
返本还原	fan'ben'huan'yuan	1
返哺之恩	fan'bu'zhi'en	1
反哺之情	fan'bu'zhi'qing	1
反唇相稽	fan'chun'xiang'ji	1
反唇相讥	fan'chun'xiang'ji	1
犯而不校	fan'er'bu'jiao	1
泛泛而谈	fan'fan'er'tan	1
泛泛之交	fan'fan'zhi'jiao	1
泛泛之人	fan'fan'zhi'ren	1
贩夫贩妇	fan'fu'fan'fu	1
凡夫肉眼	fan'fu'rou'yan	1
凡夫俗子	fan'fu'su'zi	1
反复无常	fan'fu'wu'chang	1
翻复无常	fan'fu'wu'chang	1
贩夫走卒	fan'fu'zou'fu	1
反戈相向	fan'ge'xiang'xiang	1
反戈一击	fan'ge'yi'ji	1
反躬自问	fan'gong'zi'wen	1
反躬自省	fan'gong'zi'xing	1
繁花似锦	fan'hua'si'jin	1
反间之计	fan'jian'zhi'ji	1
翻江倒海	fan'jiang'dao'hai	1
反经行权	fan'jing'xing'quan	1
反客为主	fan'ke'wei'zhu	1
饭坑酒囊	fan'keng'jiu'nang	1
翻空出奇	fan'kong'chu'qi	1
翻来覆去	fan'lai'fu'qu	1
泛滥成灾	fan'lan'cheng'zai	1
反老还童	fan'lao'huan'tong	1
返老还童	fan'lao'huan'tong	1
反劳为逸	fan'lao'wei'yi	1
反面教员	fan'mian'jiao'yuan	1
反面文章	fan'mian'wen'zhang	1
反面无情	fan'mian'wu'qing	1
反目成仇	fan'mu'cheng'chou	1
饭囊衣架	fan'nang'yi'jia	1
泛萍浮梗	fan'ping'fu'geng	1
反璞归真	fan'pu'gui'zhen	1
返朴还淳	fan'pu'huan'chun	1
反裘负刍	fan'qiu'fu'chu	1
饭糗茹草	fan'qiu'ru'cao	1
反求诸己	fan'qiu'zhu'ji	1
翻然改进	fan'ran'gai'jin	1
幡然改途	fan'ran'gai'tu	1
翻然改图	fan'ran'gai'tu	1
翻然悔悟	fan'ran'hui'wu	1
繁荣昌盛	fan'rong'chang'sheng	1
繁荣富强	fan'rong'fu'qiang	1
翻山越岭	fan'shan'yue'ling	1
犯上作乱	fan'shang'zuo'luan	1
反手可得	fan'shou'ke'de	1
反水不收	fan'shui'bu'shou	1
凡胎浊骨	fan'tai'zhuo'gu	1
凡桃俗李	fan'tao'su'li	1
翻天覆地	fan'tian'fu'di	1
繁文末节	fan'wen'mo'jie	1
繁文缛节	fan'wen'ru'jie	1
返我初服	fan'wo'chu'fu	1
繁弦急管	fan'xian'ji'guan	1
翻箱倒柜	fan'xiang'dao'gui	1
翻箱倒箧	fan'xiang'dao'qie	1
反眼不识	fan'yan'bu'shi	1
犯颜极谏	fan'yan'ji'jian	1
烦言碎辞	fan'yan'sui'yu	1
翻云覆雨	fan'yun'fu'yu	1
范张鸡黍	fan'zhang'ji'shu	1
反治其身	fan'zhi'qi'shen	1
繁枝细节	fan'zhi'xi'jie	1
方便之门	fang'bian'zhi'men	1
防不及防	fang'bu'ji'fang	1
防不胜防	fang'bu'sheng'fang	1
方寸不乱	fang'cun'bu'luan	1
方寸万重	fang'cun'wan'chong	1
方寸已乱	fang'cun'yi'luan	1
方寸之地	fang'cun'zhi'di	1
放荡不羁	fang'dang'bu'ji	1
方底圆盖	fang'di'yuan'gai	1
放刁撒泼	fang'diao'sa'po	1
放饭流歠	fang'fan'liu'chuo	1
放歌纵酒	fang'ge'zong'jiu	1
妨功害能	fang'gong'hai'neng	1
放虎归山	fang'hu'gui'shan	1
放虎自卫	fang'hu'zi'wei	1
防患未然	fang'huan'wei'ran	1
芳兰竟体	fang'lan'jing'ti	1
放浪形骸	fang'lang'xing'hai	1
方领矩步	fang'ling'ju'bu	1
芳年华月	fang'nian'hua'yue	1
放牛归马	fang'niu'gui'ma	1
放辟邪侈	fang'pi'xie'chi	1
放任自流	fang'ren'zi'liu	1
方枘圆凿	fang'rui'yuan'zao	1
方头不劣	fang'tou'bu'lie	1
方外之人	fang'wai'zhi'ren	1
防微杜渐	fang'wei'du'jian	1
防微虑远	fang'wei'lv'yuan	1
方兴未艾	fang'xing'wei'ai	1
放言遣辞	fang'yan'qian'ci	1
防意如城	fang'yi'ru'cheng	1
方凿圆枘	fang'zao'yuan'rui	1
方正不阿	fang'zheng'bu'e	1
方趾圆颅	fang'zhi'yuan'lu	1
放纵驰荡	fang'zong'chi'dang	1
诽谤之木	fei'bang'zhi'mu	1
非常之谋	fei'chang'zhi'mou	1
非池中物	fei'chi'zhong'wu	1
飞刍挽粟	fei'chu'wan'su	1
非此即彼	fei'ci'ji'bi	1
蜚短流长	fei'duan'liu'chang	1
飞短流长	fei'duan'liu'chang	1
肥遁鸣高	fei'dun'ming'gao	1
飞遁鸣高	fei'dun'ming'kao	1
飞蛾赴火	fei'e'fu'huo	1
飞蛾投火	fei'e'tou'huo	1
沸反盈天	fei'fan'ying'tian	1
吠非其主	fei'fei'qi'zhu	1
沸沸扬扬	fei'fei'yang'yang	1
匪匪翼翼	fei'fei'yi'yi	1
非分之财	fei'fen'zhi'cai	1
非分之想	fei'fen'zhi'xiang	1
肺腑之言	fei'fu'zhi'yan	1
飞阁流丹	fei'ge'liu'dan	1
飞鸿印雪	fei'hong'yin'xue	1
废话连篇	fei'hua'lian'pian	1
飞黄腾达	fei'huang'teng'da	1
匪夷匪惠	fei'ji'fei'hui	1
费尽心机	fei'jin'xin'ji	1
飞来横祸	fei'lai'heng'huo	1
费力劳心	fei'li'lao'xin	1
非驴非马	fei'lv'fei'ma	1
肥马轻裘	fei'ma'qing'qiu	1
飞鸟惊蛇	fei'niao'jing'she	1
飞鸟依人	fei'niao'yi'ren	1
飞蓬随风	fei'peng'sui'feng	1
非亲非故	fei'qin'fei'gu	1
废寝忘食	fei'qin'wang'shi	1
飞禽走兽	fei'qin'zou'shou	1
斐然成章	fei'ran'cheng'zhang	1
废然而返	fei'ran'er'fan	1
飞沙走石	fei'sha'zou'shi	1
飞沙走砾	fei'she'zou'li	1
飞声腾实	fei'sheng'teng'shi	1
菲食薄衣	fei'shi'bo'yi	1
匪石匪席	fei'shi'fei'xi	1
肺石风清	fei'shi'feng'qing	1
废书而叹	fei'shu'er'tan	1
非同儿戏	fei'tong'er'xi	1
非同小可	fei'tong'xiao'ke	1
肥头大耳	fei'tou'da'er	1
废文任武	fei'wen'ren'wu	1
非我族类	fei'wo'zu'lei	1
非昔是今	fei'xi'shi'jin	1
吠形吠声	fei'xing'fei'sheng	1
飞熊入梦	fei'xiong'ru'meng	1
飞檐走壁	fei'yan'zou'bi	1
飞扬跋扈	fei'yang'ba'hu	1
非异人任	fei'yi'ren'ren	1
匪夷所思	fei'yi'suo'si	1
非意相干	fei'yi'xiang'gan	1
匪伊朝夕	fei'yi'zhao'xi	1
吠影吠声	fei'ying'fei'sheng	1
飞鹰走狗	fei'ying'zou'gou	1
诽誉在俗	fei'yu'zai'su	1
非愚则诬	fei'yu'ze'wu	1
飞云掣电	fei'yun'che'dian	1
飞灾横祸	fei'zai'heng'huo	1
飞针走线	fei'zhen'zou'xian	1
粉白黛黑	fen'bai'dai'hei	1
粉白黛绿	fen'bai'dai'lv	1
分崩离析	fen'beng'li'xi	1
分别部居	fen'bie'bu'ju	1
奋不顾身	fen'bu'gu'shen	1
愤不欲生	fen'bu'yu'sheng	1
分钗断带	fen'chai'duan'dai	1
分钗破镜	fen'chai'po'jing	1
分寸之末	fen'cun'zhi'mo	1
分道扬镳	fen'dao'yang'biao	1
奋发蹈厉	fen'fa'dao'li	1
奋发图强	fen'fa'tu'qiang	1
奋发有为	fen'fa'you'wei	1
芬芳馥郁	fen'fang'fu'yu	1
愤愤不平	fen'fen'bu'ping	1
纷纷攘攘	fen'fen'rang'rang	1
纷纷扬扬	fen'fen'yang'yang	1
分风劈流	fen'feng'pi'liu	1
分甘共苦	fen'gan'gong'ku	1
分甘绝少	fen'gan'jue'shao	1
焚膏继晷	fen'gao'ji'gui	1
焚骨扬灰	fen'gu'yang'hui	1
分毫不爽	fen'hao'bu'shuang	1
分毫析厘	fen'hao'xi'li	1
纷红骇绿	fen'hong'hai'lv	1
分化瓦解	fen'hua'wa'jie	1
分斤掰两	fen'jin'bai'liang	1
分居异爨	fen'ju'yi'cuan	1
焚林而猎	fen'lin'er'lie	1
分路扬镳	fen'lu'yang'biao	1
纷乱如麻	fen'luan'ru'ma	1
分茅裂土	fen'mao'lie'tu	1
奋袂而起	fen'mei'er'qi	1
分门别户	fen'men'bie'hu	1
分门别类	fen'men'bie'lei	1
粉面油头	fen'mian'you'tou	1
分秒必争	fen'miao'bi'zheng	1
粉墨登场	fen'mo'deng'chang	1
分内之事	fen'nei'zhi'shi	1
奋起直追	fen'qi'zhi'zhui	1
焚琴煮鹤	fen'qin'zhu'he	1
忿然作色	fen'ran'zuo'se	1
粉身碎骨	fen'shen'sui'gu	1
分身无术	fen'shen'wu'shu	1
愤世嫉俗	fen'shi'ji'su	1
粉饰太平	fen'shi'tai'ping	1
分守要津	fen'shou'yao'jin	1
焚书坑儒	fen'shu'keng'ru	1
分庭抗礼	fen'ting'kang'li	1
粪土不如	fen'tu'bu'ru	1
分外妖娆	fen'wai'yao'rao	1
分文不名	fen'wen'bu'ming	1
分文不取	fen'wen'bu'qu	1
分文不直	fen'wen'bu'zhi	1
分我杯羹	fen'wo'bei'geng	1
焚香礼拜	fen'xian'li'bai	1
分香卖履	fen'xiang'mai'lv	1
分形同气	fen'xing'tong'qi	1
奋勇当先	fen'yong'dang'xian	1
纷纭杂沓	fen'yun'za'ta	1
纷至沓来	fen'zhi'ta'lai	1
焚舟破釜	fen'zhou'po'fu	1
粉妆玉琢	fen'zhuang'yu'zhuo	1
锋不可当	feng'bu'ke'dang	1
风不鸣条	feng'bu'ming'tiao	1
风餐露宿	feng'can'lu'su	1
蜂虿有毒	feng'chai'you'du	1
逢场作戏	feng'chang'zuo'xi	1
风掣雷行	feng'che'lei'xing	1
风尘碌碌	feng'chen'lu'lu	1
风尘仆仆	feng'chen'pu'pu	1
风尘之变	feng'chen'zhi'bian	1
风驰电掣	feng'chi'dian'che	1
风吹草动	feng'chui'cao'dong	1
风吹浪打	feng'chui'lang'da	1
风吹雨打	feng'chui'yu'da	1
风刀霜剑	feng'dao'shuang'jian	1
风度翩翩	feng'du'pian'pian	1
锋发韵流	feng'fa'yun'liu	1
葑菲之采	feng'fei'zhi'cai	1
风风火火	feng'feng'huo'huo	1
风风雨雨	feng'feng'yu'yu	1
丰富多采	feng'fu'duo'cai	1
奉公不阿	feng'gong'bu'e	1
奉公守法	feng'gong'shou'fa	1
丰功伟绩	feng'gong'wei'ji	1
奉公正己	feng'gong'zheng'ji	1
烽鼓不息	feng'gu'bu'xi	1
风骨峭峻	feng'gu'qiao'jun	1
凤冠霞帔	feng'guan'xia'pei	1
封官许愿	feng'guan'xu'yuan	1
风光旖旎	feng'guang'yi'ni	1
风和日丽	feng'he'ri'li	1
风和日暖	feng'he'ri'nuan	1
丰亨豫大	feng'heng'yu'da	1
封胡遏末	feng'hu'e'mo	1
风虎云龙	feng'hu'yun'long	1
风华绝代	feng'hua'jue'dai	1
风花雪月	feng'hua'xue'yue	1
风华正茂	feng'hua'zheng'mao	1
风鬟雾鬓	feng'huan'wu'bin	1
风鬟雨鬓	feng'huan'yu'bin	1
凤凰来仪	feng'huang'lai'yi	1
凤凰于飞	feng'huang'yu'fei	1
凤凰在笯	feng'huang'zai'nu	1
峰回路转	feng'hui'lu'zhuan	1
烽火连年	feng'huo'lian'nian	1
烽火连天	feng'huo'lian'tian	1
烽火四起	feng'huo'si'qi	1
丰筋多力	feng'jen'duo'li	1
风景不殊	feng'jing'bu'shu	1
风卷残云	feng'juan'can'yun	1
逢君之恶	feng'jun'zhi'e	1
风口浪尖	feng'kou'lang'jian	1
奉令承教	feng'ling'cheng'jiao	1
风流才子	feng'liu'cai'zi	1
风流人物	feng'liu'ren'wu	1
风流儒雅	feng'liu'ru'ya	1
风流倜傥	feng'liu'ti'tang	1
风流潇洒	feng'liu'xiao'sa	1
风流云散	feng'liu'yun'san	1
风流韵事	feng'liu'yun'shi	1
风流罪过	feng'liu'zui'guo	1
锋芒毕露	feng'mang'bi'lu	1
锋芒逼人	feng'mang'bi'ren	1
锋芒不露	feng'mang'bu'lu	1
锋芒所向	feng'mang'suo'xiang	1
凤毛济美	feng'mao'ji'mei	1
凤毛麟角	feng'mao'lin'jiao	1
凤靡鸾吪	feng'mi'luan'e	1
风靡一时	feng'mi'yi'shi	1
奉命唯谨	feng'ming'wei'jin	1
凤鸣朝阳	feng'ming'zhao'yang	1
蜂目豺声	feng'mu'chai'sheng	1
风木含悲	feng'mu'han'bei	1
丰年稔岁	feng'nian'ren'sui	1
风平波息	feng'ping'bo'xi	1
风平浪静	feng'ping'lang'jing	1
风起水涌	feng'qi'shui'yong	1
封妻荫子	feng'qi'yin'zi	1
风起云涌	feng'qi'yun'yong	1
风起云蒸	feng'qi'yun'zheng	1
风前残烛	feng'qian'can'zhu	1
风前月下	feng'qian'yue'xia	1
风樯阵马	feng'qiang'zhen'ma	1
风清弊绝	feng'qing'bi'jue	1
风清月皎	feng'qing'yue'jiao	1
风清月朗	feng'qing'yue'lang	1
风情月债	feng'qing'yue'zhai	1
风趣横生	feng'qu'heng'sheng	1
丰取刻与	feng'qu'ke'yu	1
逢人说项	feng'ren'shuo'xiang	1
奉若神明	feng'ruo'shen'ming	1
逢山开路	feng'shan'kai'lu	1
丰神绰约	feng'shen'chuo'yue	1
丰神异彩	feng'shen'yi'cai	1
封豕长蛇	feng'shi'chang'she	1
逢时遇节	feng'shi'yu'jie	1
奉天承运	feng'tian'cheng'yun	1
风调雨顺	feng'tiao'yu'shun	1
奉头鼠窜	feng'tou'shu'cuan	1
风土人情	feng'tu'ren'qing	1
蜂屯蚁聚	feng'tun'yi'ju	1
奉为圭臬	feng'wei'gui'nie	1
奉为楷模	feng'wei'kai'mo	1
奉为至宝	feng'wei'zhi'bao	1
凤枭同巢	feng'xiao'tong'chao	1
风潇雨晦	feng'xiao'yu'hui	1
风信年华	feng'xin'nian'hua	1
风行草偃	feng'xing'cao'yan	1
奉行故事	feng'xing'gu'shi	1
风行水上	feng'xing'shui'shang	1
风行一时	feng'xing'yi'shi	1
逢凶化吉	feng'xiong'hua'ji	1
风旋电掣	feng'xuan'dian'che	1
风雪交加	feng'xue'jiao'jia	1
风言醋语	feng'yan'cu'yu	1
风言风语	feng'yan'feng'yu	1
奉扬仁风	feng'yang'ren'feng	1
讽一劝百	feng'yi'quan'bai	1
丰衣足食	feng'yi'zu'shi	1
风影敷衍	feng'ying'fu'yan	1
蜂拥而来	feng'yong'er'lai	1
风雨不测	feng'yu'bu'ce	1
风雨不改	feng'yu'bu'gai	1
风雨不透	feng'yu'bu'tou	1
风雨对床	feng'yu'dui'chuang	1
风雨交加	feng'yu'jiao'jia	1
风雨飘摇	feng'yu'piao'yao	1
风雨凄凄	feng'yu'qi'qi	1
风雨如晦	feng'yu'ru'hui	1
风雨如磐	feng'yu'ru'pan	1
风雨同舟	feng'yu'tong'zhou	1
风雨无阻	feng'yu'wu'zu	1
风雨萧条	feng'yu'xiao'tiao	1
风云变幻	feng'yun'bia'huan	1
风云变态	feng'yun'bian'tai	1
风云际会	feng'yun'ji'hui	1
风云人物	feng'yun'ren'wu	1
风云突变	feng'yun'tu'bian	1
风云月露	feng'yun'yue'lu	1
风云之志	feng'yun'zhi'zhi	1
风栉雨沐	feng'zhi'yu'mu	1
风中秉烛	feng'zhong'bing'zhu	1
风中之烛	feng'zhong'zhi'zhu	1
风烛残年	feng'zhu'can'nian	1
风烛之年	feng'zhu'zhi'nian	1
佛口蛇心	fo'kou'she'xin	1
佛头加秽	fo'tou'jia'hui	1
佛头着粪	fo'tou'zhuo'fen	1
佛眼相看	fo'yan'xiang'kan	1
浮白载笔	fu'bai'zai'bi	1
拊背扼喉	fu'bei'e'hou	1
腹背受敌	fu'bei'shou'di	1
腹背之毛	fu'bei'zhi'mao	1
夫唱妇随	fu'chang'fu'sui	1
辅车唇齿	fu'che'chun'chi	1
辅车相依	fu'che'xiang'yi	1
覆车之轨	fu'che'zhi'gui	1
覆车之鉴	fu'che'zhi'jian	1
覆车之戒	fu'che'zhi'jie	1
父慈子孝	fu'ci'zi'xiao	1
复蹈前辙	fu'dao'qian'zhe	1
负德辜恩	fu'de'gu'en	1
釜底抽薪	fu'di'chou'xin	1
福地洞天	fu'di'dong'tian	1
覆地翻天	fu'di'fan'tian	1
伏地圣人	fu'di'sheng'ren	1
釜底游鱼	fu'di'you'yu	1
伏低做小	fu'di'zuo'xiao	1
服低做小	fu'di'zuo'xiao	1
扶颠持危	fu'dian'chi'wei	1
负恩昧良	fu'en'mei'liang	1
附耳低言	fu'er'di'yan	1
伏而咶天	fu'er'shi'tian	1
伏法受诛	fu'fa'shou'zhu	1
腹诽心谤	fu'fei'xin'bang	1
傅粉何郎	fu'fen'he'lang	1
傅粉施朱	fu'fen'shi'zhu	1
附肤落毛	fu'fu'luo'mao	1
抚躬自问	fu'gong'zi'wen	1
妇姑勃谿	fu'gu'bo'xi	1
桴鼓相应	fu'gu'xiang'ying	1
浮瓜沉李	fu'gua'chen'li	1
浮光掠影	fu'guang'lve'ying	1
富贵逼人	fu'gui'bi'ren	1
簠簋不饬	fu'gui'bu'chi	1
富贵浮云	fu'gui'fu'yun	1
富贵骄人	fu'gui'jiao'ren	1
富贵荣华	fu'gui'rong'hua	1
富国安民	fu'guo'an'min	1
富国强兵	fu'guo'qiang'bing	1
福过灾生	fu'guo'zai'sheng	1
覆海移山	fu'hai'yi'shan	1
伏虎降龙	fu'hu'xiang'long	1
浮花浪蕊	fu'hua'lang'rui	1
福慧双修	fu'hui'shuang'xiu	1
附骥名彰	fu'ji'ming'zhang	1
附骥攀鸿	fu'ji'pan'hong	1
缚鸡之力	fu'ji'zhi'li	1
浮家泛宅	fu'jia'fan'zhai	1
抚今追昔	fu'jin'zhui'xi	1
凫胫鹤膝	fu'jing'he'xi	1
负荆请罪	fu'jing'qing'zui	1
抚景伤情	fu'jing'shang'qing	1
复旧如初	fu'jiu'ru'chu	1
富可敌国	fu'ke'di'guo	1
扶老携幼	fu'lao'xie'you	1
负老携幼	fu'lao'xie'you	1
富丽堂皇	fu'li'tang'huang	1
富埒陶白	fu'lie'tao'bai	1
伏龙凤雏	fu'long'feng'chu	1
福禄双全	fu'lu'shuang'quan	1
富面百城	fu'mian'bai'cheng	1
浮名薄利	fu'ming'bo'li	1
浮名虚誉	fu'ming'xu'yu	1
父母恩勤	fu'mu'en'qin	1
父母之邦	fu'mu'zhi'bang	1
负驽前驱	fu'nu'qian'qu	1
覆盆之冤	fu'pen'zhi'yuan	1
浮皮潦草	fu'pi'liao'cao	1
肤皮潦草	fu'pi'liao'cao	1
负气斗狠	fu'qi'dou'hen	1
夫妻反目	fu'qi'fan'mu	1
负气仗义	fu'qi'zhang'yi	1
扶墙摸壁	fu'qiang'mo'bi	1
扶倾济弱	fu'qing'ji'ruo	1
负屈含冤	fu'qu'han'yuan	1
凫趋雀跃	fu'qu'que'yue	1
负屈衔冤	fu'qu'xian'yuan	1
怫然不悦	fu'ran'bu'yue	1
怫然作色	fu'ran'zuo'se	1
夫人裙带	fu'ren'qun'dai	1
妇人之仁	fu'ren'zhi'ren	1
芙蓉并蒂	fu'rong'bing'di	1
芙蓉出水	fu'rong'chu'shui	1
夫荣妻贵	fu'rong'qi'gui	1
福如东海	fu'ru'dong'hai	1
妇孺皆知	fu'ru'jie'zhi	1
扶弱抑强	fu'ruo'yi'qiang	1
福善祸淫	fu'shan'huo'yin	1
附上罔下	fu'shang'wang'xia	1
浮声切响	fu'sheng'qie'xiang	1
浮生若梦	fu'sheng'ruo'meng	1
俯拾地芥	fu'shi'di'jie	1
俯拾即是	fu'shi'ji'shi	1
俯拾皆是	fu'shi'jie'shi	1
俯拾仰取	fu'shi'yang'qu	1
辅世长民	fu'shi'zhang'min	1
俯首就缚	fu'shou'jiu'fu	1
福寿绵绵	fu'shou'mian'mian	1
福寿齐天	fu'shou'qi'tian	1
俯首帖耳	fu'shou'tie'er	1
俯首听命	fu'shou'ting'ming	1
福寿无疆	fu'shou'wu'jiang	1
肤受之诉	fu'shou'zhi'su	1
肤受之言	fu'shou'zhi'yan	1
覆水难收	fu'shui'nan'shou	1
抚绥万方	fu'sui'wan'fang	1
赴汤蹈火	fu'tang'dao'huo	1
服田力穑	fu'tian'li'se	1
覆亡无日	fu'wang'wu'ri	1
扶危定乱	fu'wei'ding'luan	1
扶危济困	fu'wei'ji'kun	1
父为子隐	fu'wei'zi'yin	1
浮文巧语	fu'wen'qiao'yu	1
福无双至	fu'wu'shuang'zhi	1
赴险如夷	fu'xian'ru'yi	1
浮想联翩	fu'xiang'lian'pian	1
负薪救火	fu'xin'jiu'huo	1
负心违愿	fu'xin'wei'yuan	1
腹心相照	fu'xin'xiang'zhao	1
腹心之疾	fu'xin'zhi'ji	1
负薪之忧	fu'xin'zhi'you	1
抚心自问	fu'xin'zi'wen	1
拂袖而归	fu'xiu'er'gui	1
拂袖而去	fu'xiu'er'qu	1
敷衍了事	fu'yan'liao'shi	1
敷衍塞责	fu'yan'se'ze	1
父严子孝	fu'yan'zi'xiao	1
俯仰唯唯	fu'yang'wei'wei	1
俯仰无愧	fu'yang'wu'kui	1
俯仰由人	fu'yang'you'ren	1
俯仰之间	fu'yang'zhi'jian	1
扶摇万里	fu'yao'wan'li	1
扶摇直上	fu'yao'zhi'shang	1
浮一大白	fu'yi'da'bai	1
福倚祸伏	fu'yi'huo'fu	1
附庸风雅	fu'yong'feng'ya	1
腹有鳞甲	fu'you'lin'jia	1
覆雨翻云	fu'yu'fan'yun	1
负隅顽抗	fu'yu'wan'kang	1
浮语虚辞	fu'yu'xu'ci	1
斧钺汤镬	fu'yue'tang'huo	1
斧钺之诛	fu'yue'zhi'zhu	1
浮云蔽日	fu'yun'bi'ri	1
浮云富贵	fu'yun'fu'gui	1
浮云朝露	fu'yun'zhao'lu	1
腹载五车	fu'zai'wu'che	1
富在知足	fu'zai'zhi'zu	1
抚掌大笑	fu'zhang'da'xiao	1
付之丙丁	fu'zhi'bing'ding	1
付之东流	fu'zhi'dong'liu	1
福至心灵	fu'zhi'xin'ling	1
付之一炬	fu'zhi'yi'ju	1
付之一叹	fu'zhi'yi'tan	1
付之一笑	fu'zhi'yi'xiao	1
腹中兵甲	fu'zhong'bing'jia	1
釜中生鱼	fu'zhong'sheng'yu	1
釜中游鱼	fu'zhong'you'yu	1
负重致远	fu'zhong'zhi'yuan	1
覆舟之戒	fu'zhou'zhi'jie	1
付诸东流	fu'zhu'dong'liu	1
付诸洪乔	fu'zhu'hong'qiao	1
附赘悬疣	fu'zhui'xuan'you	1
夫子自道	fu'zi'zi'dao	1
浮踪浪迹	fu'zong'lang'ji	1
改步改玉	gai'bu'gai'yu	1
盖不由己	gai'bu'you'ji	1
改操易节	gai'cao'yi'jie	1
改朝换代	gai'chao'huan'dai	1
改恶向善	gai'e'xiang'shan	1
改恶行善	gai'e'xing'shan	1
盖棺论定	gai'guan'lun'ding	1
改过不吝	gai'guo'bu'lin	1
改过迁善	gai'guo'qian'shan	1
改过自新	gai'guo'zi'xin	1
改换家门	gai'huan'jia'men	1
改名换姓	gai'ming'huan'xing	1
概莫能外	gai'mo'neng'wai	1
改容易貌	gai'rong'yi'mao	1
改是成非	gai'shi'cheng'fei	1
盖世无双	gai'shi'wu'shuang	1
盖世英雄	gai'shi'ying'xiong	1
盖世之才	gai'shi'zhi'cai	1
改俗迁风	gai'su'qian'feng	1
改天换地	gai'tian'huan'di	1
改头换面	gai'tou'huan'mian	1
改头换尾	gai'tou'huan'wei	1
改弦更张	gai'xian'geng'zhang	1
改弦易辙	gai'xian'yi'zhe	1
改邪归正	gai'xie'gui'zheng	1
改辕易辙	gai'yuan'yi'zhe	1
甘败下风	gan'bai'xia'feng	1
敢不承命	gan'bu'cheng'ming	1
干柴烈火	gan'chai'lie'huo	1
肝肠寸断	gan'chang'cun'duan	1
干城之将	gan'cheng'zhi'jiang	1
肝胆楚越	gan'dan'chu'yue	1
肝胆过人	gan'dan'guo'ren	1
肝胆相照	gan'dan'xiang'zhao	1
肝胆欲碎	gan'dan'yu'sui	1
感恩戴德	gan'en'dai'de	1
感恩图报	gan'en'tu'bao	1
干父之蛊	gan'fu'zhi'gu	1
甘瓜苦蒂	gan'gua'ku'di	1
感激涕零	gan'ji'ti'ling	1
干将莫邪	gan'jiang'mo'ye	1
感今怀昔	gan'jin'huai'xi	1
赶尽杀绝	gan'jin'sha'jue	1
干净利落	gan'jing'li'luo	1
感旧之哀	gan'jiu'zhi'ai	1
甘居人后	gan'ju'ren'hou	1
感慨万端	gan'kai'wan'duan	1
感慨万千	gan'kai'wan'qian	1
感慨系之	gan'kai'xi'zhi	1
甘苦与共	gan'ku'yu'gong	1
干名采誉	gan'ming'cai'yu	1
肝脑涂地	gan'nao'tu'di	1
敢怒敢言	gan'nu'gan'yan	1
甘贫乐道	gan'pin'le'dao	1
干卿底事	gan'qing'di'shi	1
感情用事	gan'qing'yong'shi	1
感人肺腑	gan'ren'fei'fu	1
甘死如饴	gan'si'ru'yi	1
甘棠遗爱	gan'tang'yi'ai	1
感天动地	gan'tian'dong'di	1
感同身受	gan'tong'shen'shou	1
竿头日进	gan'tou'ri'jin	1
竿头直上	gan'tou'zhi'shang	1
干霄凌云	gan'xiao'ling'yun	1
甘心瞑目	gan'xin'ming'mu	1
甘心情愿	gan'xin'qing'yuan	1
肝心若裂	gan'xin'ruo'lie	1
甘心首疾	gan'xin'shou'ji	1
甘言美语	gan'yan'mei'yu	1
甘雨随车	gan'yu'sui'che	1
感遇忘身	gan'yu'wang'shen	1
干云蔽日	gan'yun'bi'ri	1
甘之如饴	gan'zhi'ru'yi	1
敢作敢当	gan'zuo'gan'dang	1
刚愎自用	gang'bi'zi'yong	1
刚肠嫉恶	gang'chang'ji'e	1
钢筋铁骨	gang'jing'tie'gu	1
纲举目张	gang'ju'mu'zhang	1
刚柔相济	gang'rou'xiang'ji	1
刚毅木讷	gang'yi'mu'ne	1
刚直不阿	gang'zhi'bu'e	1
刚中柔外	gang'zhong'rou'wai	1
高岸深谷	gao'an'shen'gu	1
高傲自大	gao'ao'zi'da	1
高不可攀	gao'bu'ke'pan	1
高步云衢	gao'bu'yun'qu	1
高材疾足	gao'cai'ji'zu	1
高材捷足	gao'cai'jie'zu	1
高唱入云	gao'chang'ru'yun	1
高车驷马	gao'che'si'ma	1
高城深池	gao'cheng'shen'chi	1
高出一筹	gao'chu'yi'chou	1
膏唇试舌	gao'chun'shi'she	1
告贷无门	gao'dai'wu'men	1
高蹈远举	gao'dao'yuan'ju	1
高飞远举	gao'fei'yuan'ju	1
高风亮节	gao'feng'liang'jie	1
高高在上	gao'gao'zai'shang	1
高歌猛进	gao'ge'meng'jin	1
高冠博带	gao'guan'bo'dai	1
高官厚禄	gao'guan'hou'lu	1
高官显爵	gao'guan'xian'jue	1
膏肓之疾	gao'huang'zhi'ji	1
膏火之费	gao'huo'zhi'fei	1
膏火自煎	gao'huo'zi'jian	1
高节清风	gao'jie'qing'feng	1
告老还家	gao'lao'huan'jia	1
膏梁锦绣	gao'liang'jin'xiu	1
膏梁纨袴	gao'liang'wan'ku	1
膏梁子弟	gao'liang'zi'di	1
高门大户	gao'men'da'hu	1
高名大姓	gao'ming'da'xing	1
槁木死灰	gao'mu'si'hui	1
高睨大谈	gao'ni'da'tan	1
高朋满座	gao'peng'man'zuo	1
高情远致	gao'qing'yuan'zhi	1
高人雅士	gao'ren'ya'shi	1
高人一筹	gao'ren'yi'chou	1
高人一等	gao'ren'yi'deng	1
高山景行	gao'shan'jing'xing	1
高山流水	gao'shan'liu'shui	1
高山仰止	gao'shan'yang'zhi	1
高深莫测	gao'shen'mo'ce	1
高世骇俗	gao'shi'hai'su	1
高视阔步	gao'shi'kuo'bu	1
高耸入云	gao'song'ru'yun	1
高抬贵手	gao'tai'gui'shou	1
高谈弘论	gao'tan'hong'lun	1
高谈阔论	gao'tan'kuo'lun	1
高谈雄辩	gao'tan'xiong'bian	1
告往知来	gao'wang'zhi'lai	1
高位厚禄	gao'wei'hou'lu	1
高文典册	gao'wen'dian'ce	1
高卧东山	gao'wo'dong'shan	1
高屋建瓴	gao'wu'jian'ling	1
高下在心	gao'xia'zai'xin	1
槁项黄馘	gao'xiang'huang'xu	1
高翔远引	gao'xiang'yuan'yin	1
高悬秦镜	gao'xuan'qin'jing	1
高牙大纛	gao'ya'da'dao	1
高阳酒徒	gao'yang'jiu'tu	1
高义薄云	gao'yi'bo'yun	1
膏腴之地	gao'yu'zhi'di	1
高瞻远瞩	gao'zhan'yuan'zhu	1
高掌远蹠	gao'zhang'yuan'zhi	1
高枕而卧	gao'zhen'er'wo	1
高枕无忧	gao'zhen'wu'you	1
缟纻之交	gao'zhu'zhi'jiao	1
高自标置	gao'zi'biao'zhi	1
高自位置	gao'zi'wei'zhi	1
高足弟子	gao'zu'di'zi	1
隔岸观火	ge'an'guan'huo	1
各奔前程	ge'ben'qian'cheng	1
割臂盟公	ge'bi'meng'gong	1
割臂之盟	ge'bi'zhi'meng	1
各不相谋	ge'bu'xiang'mou	1
各不相让	ge'bu'xiang'rang	1
各持己见	ge'chi'ji'jian	1
各从其志	ge'cong'qi'zhi	1
革带移孔	ge'dai'yi'kong	1
各得其所	ge'de'qi'suo	1
割地称臣	ge'di'cheng'chen	1
割地求和	ge'di'qiu'he	1
割肚牵肠	ge'du'qian'chang	1
革风易俗	ge'feng'yi'su	1
格格不入	ge'ge'bu'ru	1
各个击破	ge'ge'ji'po	1
歌功颂德	ge'gong'song'de	1
革故鼎新	ge'gu'ding'xin	1
割骨疗亲	ge'gu'liao'qin	1
革奸铲暴	ge'jian'chan'bao	1
各尽所能	ge'jin'suo'neng	1
割襟之盟	ge'jin'zhi'meng	1
革旧维新	ge'jiu'wei'xin	1
歌楼舞榭	ge'lou'wu'xie	1
革面敛手	ge'mian'lian'shou	1
革面洗心	ge'mian'xi'xin	1
革命反正	ge'ming'fan'zheng	1
隔年皇历	ge'nian'huang'li	1
隔墙有耳	ge'qiang'you'er	1
各取所长	ge'qu'suo'chang	1
各色名样	ge'se'ge'yang	1
各色人等	ge'se'ren'deng	1
格杀不论	ge'sha'bu'lun	1
格杀勿论	ge'sha'wu'lun	1
歌声绕梁	ge'sheng'rao'liang	1
隔世之感	ge'shi'zhi'gan	1
各抒己见	ge'shu'ji'jian	1
歌台舞榭	ge'tai'wu'xie	1
革图易虑	ge'tu'yi'lv	1
各为其主	ge'wei'qi'zhu	1
歌舞升平	ge'wu'sheng'ping	1
格物致知	ge'wu'zhi'zhi	1
割席分坐	ge'xi'fen'zuo	1
各行其是	ge'xing'qi'shi	1
隔靴搔痒	ge'xue'sao'yang	1
歌莺舞燕	ge'ying'wu'yan	1
各有千秋	ge'you'qian'qiu	1
各有所长	ge'you'suo'cheng	1
各有所短	ge'you'suo'duan	1
各有所好	ge'you'suo'hao	1
各有所职	ge'you'suo'zhi	1
各执己见	ge'zhi'ji'jian	1
各执一词	ge'zhi'yi'ci	1
个中妙趣	ge'zhong'miao'qu	1
个中滋味	ge'zhong'zi'wei	1
各自为战	ge'zi'wei'zhan	1
各自为政	ge'zi'wei'zheng	1
亘古不灭	gen'gu'bu'mie	1
亘古奇闻	gen'gu'qi'wen	1
亘古通今	gen'gu'tong'jin	1
亘古未有	gen'gu'wei'you	1
根深柢固	gen'shen'di'gu	1
根深蒂固	gen'shen'di'gu	1
根生土长	gen'shen'tu'zhang	1
根深叶茂	gen'shen'ye'mao	1
更长梦短	geng'chang'meng'duan	1
耕当问奴	geng'dang'wen'nu	1
绠短汲深	geng'duan'ji'shen	1
梗泛萍飘	geng'fan'ping'piao	1
耿耿于怀	geng'geng'yu'huai	1
耿耿于心	geng'geng'yu'xin	1
庚癸频呼	geng'gui'pin'hu	1
庚癸之呼	geng'gui'zhi'hu	1
更进一竿	geng'jin'yi'gan	1
更阑人静	geng'lan'ren'jing	1
更令明号	geng'ling'ming'hao	1
更仆难数	geng'pu'nan'shu	1
更深人静	geng'shen'ren'jing	1
更深夜静	geng'shen'ye'jing	1
耕耘树艺	geng'yun'shu'yi	1
功败垂成	gong'bai'chui'cheng	1
公报私仇	gong'bao'si'chou	1
功标青史	gong'biao'qing'shi	1
功薄蝉翼	gong'bo'chan'yi	1
供不应求	gong'bu'ying'qiu	1
公才公望	gong'cai'gong'wang	1
宫车晏驾	gong'che'yan'jia	1
功成不居	gong'cheng'bu'ju	1
攻城略地	gong'cheng'lve'di	1
功成名就	gong'cheng'ming'jiu	1
功成名遂	gong'cheng'ming'sui	1
功成身退	gong'cheng'shen'tui	1
功成行满	gong'cheng'xing'man	1
攻城野战	gong'cheng'ye'zhan	1
觥筹交错	gong'chou'jiao'cuo	1
功德无量	gong'de'wu'liang	1
功德圆满	gong'de'yuan'man	1
弓调马服	gong'diao'ma'fu	1
公而忘私	gong'er'wang'si	1
恭而有礼	gong'er'you'li	1
恭逢其盛	gong'feng'qi'sheng	1
躬逢其盛	gong'feng'qi'sheng	1
功高盖世	gong'gao'gai'shi	1
功高震主	gong'gao'zhen'zhu	1
躬耕乐道	gong'geng'le'dao	1
供过于求	gong'guo'yu'qiu	1
恭贺新禧	gong'he'xin'xi	1
拱肩缩背	gong'jan'suo'bei	1
恭敬桑梓	gong'jing'sang'zi	1
攻苦食淡	gong'ku'shi'dan	1
功亏一篑	gong'kui'yi'kui	1
工力悉敌	gong'li'xi'di	1
公门桃李	gong'men'tao'li	1
恭默守静	gong'mo'shou'jing	1
公平无私	gong'ping'wu'si	1
公平正直	gong'ping'zheng'zhi	1
攻其不备	gong'qi'bu'bei	1
攻其无备	gong'qi'wu'bei	1
公事公办	gong'shi'gong'ban	1
拱手而降	gong'shou'er'xiang	1
拱手让人	gong'shou'rang'ren	1
拱手听命	gong'shou'ting'ming	1
攻守同盟	gong'shou'tong'meng	1
公私兼顾	gong'si'jian'gu	1
公私两便	gong'si'liang'bian	1
躬体力行	gong'ti'li'xing	1
公听并观	gong'ting'bing'guan	1
共挽鹿车	gong'wan'lu'che	1
共为唇齿	gong'wei'chun'chi	1
攻无不克	gong'wu'bu'ke	1
攻心为上	gong'xin'wei'shang	1
躬行节俭	gong'xing'jie'jian	1
躬行实践	gong'xing'shi'jian	1
恭行天罚	gong'xing'tian'fa	1
功行圆满	gong'xing'yuan'man	1
弓折刀尽	gong'zhe'dao'jin	1
公正廉明	gong'zheng'lian'ming	1
公正无私	gong'zheng'wu'si	1
共枝别干	gong'zhi'bie'gan	1
公之于众	gong'zhi'yu'zhong	1
公诸同好	gong'zhu'tong'hao	1
公子哥儿	gong'zi'ge'er	1
公子王孙	gong'zi'wang'sun	1
苟安一隅	gou'an'yi'yu	1
狗恶酒酸	gou'e'jiu'suan	1
狗吠不惊	gou'fei'bu'jing	1
狗吠非主	gou'fei'fei'zhu	1
狗吠之警	gou'fei'zhi'jing	1
狗苟蝇营	gou'gou'ying'ying	1
苟合取容	gou'he'qu'an	1
勾魂摄魄	gou'hun'she'po	1
篝火狐鸣	gou'huo'hu'ming	1
狗急跳墙	gou'ji'tiao'qiang	1
钩金舆羽	gou'jin'yu'yu	1
沟满壕平	gou'man'hao'ping	1
苟且偷安	gou'qie'tou'an	1
苟且偷生	gou'qie'tou'sheng	1
苟且之心	gou'qie'zhi'xin	1
苟全性命	gou'quan'xing'ming	1
诟如不闻	gou'ru'bu'wen	1
钩深索隐	gou'shen'suo'yin	1
钩深致远	gou'shen'zhi'yuan	1
狗头军师	gou'tou'jun'shi	1
狗尾续貂	gou'wei'xu'diao	1
勾心斗角	gou'xin'dou'jiao	1
钩心斗角	gou'xin'dou'jiao	1
钩玄提要	gou'xuan'ti'yao	1
狗血淋头	gou'xue'lin'tou	1
狗血喷头	gou'xue'pen'tou	1
苟延残喘	gou'yan'can'chuan	1
狗眼看人	gou'yan'kan'ren	1
钩元提要	gou'yuan'ti'yao	1
钩章棘句	gou'zhang'ji'ju	1
狗仗人势	gou'zhang'ren'shi	1
钩爪锯牙	gou'zhao'ju'ya	1
狗彘不若	gou'zhi'bu'ruo	1
钩辀格磔	gou'zhou'ge'zhe	1
孤傲不群	gu'ao'bu'qun	1
孤标傲世	gu'biao'ao'shi	1
固步自封	gu'bu'zi'feng	1
故步自封	gu'bu'zi'feng	1
孤臣孽子	gu'chen'nie'zi	1
孤雏腐鼠	gu'chu'fu'shu	1
鼓唇弄舌	gu'chun'nong'she	1
顾此失彼	gu'ci'shi'bi	1
古道热肠	gu'dao're'chang	1
古调不弹	gu'diao'bu'tan	1
古调单弹	gu'diao'dan'tan	1
孤犊触乳	gu'du'chu'ru	1
孤独鳏寡	gu'du'guan'gua	1
辜恩背义	gu'en'bei'yi	1
孤儿寡妇	gu'er'gua'fu	1
孤芳自赏	gu'fang'zi'shang	1
古肥今瘠	gu'fei'jin'shou	1
顾复之恩	gu'fu'zhi'en	1
骨鲠在喉	gu'geng'zai'hou	1
骨鲠之臣	gu'geng'zhi'chen	1
故宫禾黍	gu'gong'he'shu	1
股肱之力	gu'gong'zhi'li	1
骨寒毛竖	gu'han'mao'shu	1
孤鸿寡鹄	gu'hong'gua'hu	1
蛊惑人心	gu'huo'ren'xin	1
故技重演	gu'ji'chong'yan	1
毂击肩摩	gu'ji'jian'mo	1
孤家寡人	gu'jia'gua'ren	1
故剑情深	gu'jian'qing'shen	1
谷贱伤农	gu'jian'shang'nong	1
鼓角齐鸣	gu'jiao'qi'ming	1
古今中外	gu'jin'zhong'wai	1
古井无波	gu'jing'wu'bo	1
故旧不弃	gu'jiu'bu'qi	1
孤军奋战	gu'jun'fen'zhan	1
孤军作战	gu'jun'zuo'zhan	1
孤苦伶仃	gu'ku'ling'ding	1
孤立无援	gu'li'wu'yuan	1
孤陋寡闻	gu'lou'gua'wen	1
孤鸾寡鹄	gu'luan'gua'hu	1
顾虑重重	gu'lv'chong'chong	1
古貌古心	gu'mao'gu'xin	1
沽名钓誉	gu'ming'diao'yu	1
顾名思义	gu'ming'si'yi	1
故弄玄虚	gu'nong'xuan'xu	1
顾盼生姿	gu'pan'sheng'zi	1
顾盼自雄	gu'pan'zi'xiong	1
鼓盆之戚	gu'pen'zhi'qi	1
顾曲周郎	gu'qu'zhou'lang	1
顾犬补牢	gu'quan'bu'lao	1
顾全大局	gu'quan'da'ju	1
骨肉离散	gu'rou'li'san	1
骨肉团圆	gu'rou'tuan'yuan	1
骨肉未寒	gu'rou'wei'han	1
骨肉相残	gu'rou'xiang'can	1
骨肉相连	gu'rou'xiang'lian	1
骨肉至亲	gu'rou'zhi'qin	1
故入人罪	gu'ru'ren'zui	1
骨软筋酥	gu'ruan'jin'su	1
固若金汤	gu'ruo'jin'tang	1
古色古香	gu'se'gu'xiang	1
孤身只影	gu'shen'zhi'ying	1
古是今非	gu'shi'jing'fei	1
骨瘦如柴	gu'shou'ru'chai	1
告朔饩羊	gu'shuo'xi'yang	1
故态复萌	gu'tai'fu'meng	1
骨腾肉飞	gu'teng'rou'fei	1
故土难离	gu'tu'nan'li	1
古往今来	gu'wang'jin'lai	1
姑妄听之	gu'wang'ting'zhi	1
姑妄言之	gu'wang'yan'zhi	1
古为今用	gu'wei'jin'yong	1
故我依然	gu'wo'yi'ran	1
鼓舞人心	gu'wu'ren'xin	1
姑息养奸	gu'xi'yang'jian	1
古稀之年	gu'xi'zhi'nian	1
孤行己见	gu'xing'ji'jian	1
姑射神人	gu'ye'shen'ren	1
顾影弄姿	gu'ying'nong'zi	1
顾影自怜	gu'ying'zi'lian	1
孤云野鹤	gu'yun'ye'he	1
股战而栗	gu'zhan'er'li	1
孤掌难鸣	gu'zhang'nan'ming	1
股掌之上	gu'zhang'zhi'shang	1
固执己见	gu'zhi'ji'jian	1
孤注一掷	gu'zhu'yi'zhi	1
故作高深	gu'zuo'gao'shen	1
寡不敌众	gua'bu'di'zhong	1
刮肠洗胃	gua'chang'xi'wei	1
瓜瓞绵绵	gua'die'mian'mian	1
寡二少双	gua'er'shao'shuang	1
寡凫单鹄	gua'fu'dan'hu	1
刮垢磨光	gua'gou'mo'guang	1
刮骨去毒	gua'gu'qu'du	1
挂冠归去	gua'guan'gui'qu	1
挂冠求去	gua'guan'qiu'qu	1
寡鹄孤鸾	gua'hu'gu'luan	1
寡见少闻	gua'jian'shao'wen	1
瓜李之嫌	gua'li'zhi'xian	1
寡廉鲜耻	gua'lian'xian'chi	1
刮目相待	gua'mu'xiang'dai	1
刮目相看	gua'mu'xiang'kan	1
瓜剖豆分	gua'pou'dou'fen	1
寡人之疾	gua'ren'zhi'ji	1
瓜熟蒂落	gua'shu'di'luo	1
瓜田李下	gua'tian'li'xia	1
寡闻少见	gua'wen'shao'jian	1
挂一漏万	gua'yi'lou'wan	1
挂印悬牌	gua'yin'xuan'pai	1
瓜字初分	gua'zi'chu'fen	1
怪诞不经	guai'dan'bu'jing	1
怪诞诡奇	guai'dan'gui'qi	1
怪力乱神	guai'li'luan'shen	1
怪模怪样	guai'mo'guai'yang	1
乖僻邪谬	guai'pi'xie'miu	1
拐弯抹角	guai'wan'mo'jiao	1
管鲍分金	guan'bao'fen'jin	1
官报私仇	guan'bao'si'chou	1
管鲍之交	guan'bao'zhi'jiao	1
官卑职小	guan'bei'zhi'xiao	1
官逼民反	guan'bi'min'fan	1
官仓老鼠	guan'cang'lao'shu	1
管城毛颖	guan'cheng'mao'ying	1
贯穿今古	guan'chuan'jin'gu	1
官法如炉	guan'fa'ru'lu	1
灌夫骂座	guan'fu'ma'zuo	1
冠盖如云	guan'gai'ru'yun	1
冠盖相望	guan'gai'xiang'wang	1
鳏寡孤独	guan'gua'gu'du	1
官官相护	guan'guan'xiang'hu	1
观过知仁	guan'guo'zhi'ren	1
官虎吏狼	guan'hu'li'lang	1
管见所及	guan'jian'suo'ji	1
纶巾羽扇	guan'jin'yu'shan	1
冠绝一时	guan'jue'yi'shi	1
管窥筐举	guan'kui'kuang'ju	1
管窥蠡测	guan'kui'li'ce	1
冠履倒易	guan'lv'dao'yi	1
冠履倒置	guan'lv'dao'zhi	1
观眉说眼	guan'mei'shuo'yan	1
关门打狗	guan'men'da'gou	1
关门大吉	guan'men'da'ji	1
关门落闩	guan'men'luo'shuan	1
冠冕堂皇	guan'mian'tang'huang	1
管宁割席	guan'ning'ge'xi	1
冠袍带履	guan'pao'dai'lv	1
官轻势微	guan'qing'shi'wei	1
关山迢递	guan'shan'tiao'di	1
关山阻隔	guan'shan'zu'ge	1
冠上加冠	guan'shang'jia'guan	1
冠上履下	guan'shang'lv'xia	1
观望不前	guan'wang'bu'qian	1
观往知来	guan'wang'zhi'lai	1
关心民瘼	guan'xin'min'mo	1
观衅伺隙	guan'xin'si'xi	1
贯朽粟陈	guan'xiu'su'chen	1
贯朽粟腐	guan'xiu'su'fu	1
官样文章	guan'yang'wen'zhang	1
贯颐奋戟	guan'yi'fen'ji	1
贯鱼之次	guan'yu'zhi'ci	1
官运亨通	guan'yun'heng'gong	1
观者如堵	guan'zhe'ru'du	1
观者如云	guan'zhe'ru'yun	1
官止神行	guan'zhi'shen'xing	1
管中窥豹	guan'zhong'kui'bao	1
光彩夺目	guang'cai'duo'mu	1
光风霁月	guang'feng'ji'yue	1
光复旧物	guang'fu'jiu'wu	1
光怪陆离	guang'guai'lu'li	1
广寒仙子	guang'han'xian'zi	1
光辉灿烂	guang'hui'can'lan	1
广见洽闻	guang'jian'qia'wen	1
广结良缘	guang'jie'liang'yuan	1
广开言路	guang'kai'yan'lu	1
光可鉴人	guang'ke'jian'ren	1
广陵散绝	guang'ling'san'jue	1
光芒万丈	guang'mang'wan'zhang	1
光明磊落	guang'ming'lei'luo	1
光明正大	guang'ming'zheng'da	1
光前绝后	guang'qian'jue'hou	1
光前裕后	guang'qian'yu'hou	1
广厦万间	guang'sha'wan'jian	1
光天化日	guang'tian'hua'ri	1
广庭大众	guang'ting'da'zhong	1
广土众民	guang'tu'zhong'min	1
光焰万丈	guang'yan'wan'zhang	1
光阴荏苒	guang'yin'ren'ran	1
光阴似箭	guang'yin'si'jian	1
广种薄收	guang'zhong'bo'shou	1
光宗耀祖	guang'zong'yao'zu	1
鬼出电入	gui'chu'dian'ru	1
佹得佹失	gui'de'gui'shi	1
桂殿兰宫	gui'dian'lan'gong	1
贵耳贱目	gui'er'jian'mu	1
桂馥兰香	gui'fu'lan'xiang	1
鬼斧神工	gui'fu'shen'gong	1
归根到底	gui'gen'dao'di	1
归根结蒂	gui'gen'jie'di	1
贵古贱今	gui'gu'jian'jin	1
鬼鬼祟祟	gui'gui'sui'sui	1
龟鹤遐寿	gui'he'xia'shou	1
诡计多端	gui'ji'duo'duan	1
贵贱无常	gui'jian'wu'chang	1
贵贱无二	gui'jian'wu'eer	1
规矩准绳	gui'ju'zhun'sheng	1
诡谲多变	gui'jue'duo'bian	1
诡谲怪诞	gui'jue'guai'dan	1
鬼哭狼嚎	gui'ku'lang'hao	1
鬼哭神嚎	gui'ku'shen'hao	1
鬼烂神焦	gui'lan'shen'jiao	1
龟冷支床	gui'leng'zhi'chuang	1
桂林一枝	gui'lin'yi'zhi	1
龟龙鳞凤	gui'long'lin'feng	1
龟龙片甲	gui'long'pian'jia	1
归马放牛	gui'ma'fang'niu	1
龟毛兔角	gui'mao'tu'jiao	1
诡秘莫测	gui'mi'mo'ce	1
鬼迷心窍	gui'mi'xin'qiao	1
规求无度	gui'qiu'wu'du	1
归去来兮	gui'qu'lai'xi	1
归全反真	gui'quan'fan'zhen	1
贵人贱己	gui'ren'jian'ji	1
鬼神不测	gui'shen'bu'ce	1
鬼神莫测	gui'shen'mo'ce	1
鬼使神差	gui'shi'shen'chai	1
鬼头鬼脑	gui'tou'gui'nao	1
龟文鸟迹	gui'wen'niao'ji	1
诡衔窃辔	gui'xian'qie'pei	1
归心如箭	gui'xin'ru'jian	1
归心似箭	gui'xin'si'jian	1
规行矩步	gui'xing'ju'bu	1
龟厌不告	gui'yan'bu'gao	1
瑰意琦行	gui'yi'qi'xing	1
贵阴贱璧	gui'yin'jian'bi	1
龟玉毁椟	gui'yu'hui'du	1
鬼蜮伎俩	gui'yu'ji'liang	1
贵远贱近	gui'yuan'jian'jin	1
规圆矩方	gui'yuan'ju'fang	1
归真反璞	gui'zhen'fan'pu	1
归正守丘	gui'zheng'shou'qiu	1
贵壮贱老	gui'zhuang'jian'lao	1
桂子飘香	gui'zi'piao'xiang	1
滚瓜烂熟	gun'gua'lan'shu	1
衮衮诸公	gun'gun'zhu'gong	1
国步艰难	guo'bu'jian'nan	1
果不其然	guo'bu'qi'ran	1
国仇家恨	guo'chou'jia'hen	1
过而能改	guo'er'neng'gai	1
国尔忘家	guo'er'wang'jia	1
国富兵强	guo'fu'bing'qiang	1
国富民安	guo'fu'min'an	1
国富民丰	guo'fu'min'feng	1
过河拆桥	guo'he'chai'qiao	1
过河卒子	guo'he'zu'zi	1
过化存神	guo'hua'cun'shen	1
国计民生	guo'ji'min'sheng	1
国家栋梁	guo'jia'dong'liang	1
国将不国	guo'jiang'bu'guo	1
过江之鲫	guo'jiang'zhi'ji	1
过街老鼠	guo'jie'lao'shu	1
裹粮坐甲	guo'liang'zuo'jia	1
过路财神	guo'lu'cai'shen	1
过目不忘	guo'mu'bu'wang	1
过目成诵	guo'mu'cheng'song	1
国难当头	guo'nan'dang'tou	1
国破家亡	guo'po'jia'wang	1
过桥抽板	guo'qiao'chou'ban	1
果然如此	guo'ran'ru'ci	1
国色天香	guo'se'tian'xiang	1
国色天姿	guo'se'tian'zi	1
过甚其词	guo'shen'qi'ci	1
裹尸马革	guo'shi'ma'ge	1
国士无双	guo'shi'wu'shuang	1
国泰民安	guo'tai'min'an	1
过庭之训	guo'ting'zhi'xun	1
过为已甚	guo'wei'yi'shen	1
国无二君	guo'wu'er'jun	1
国无宁日	guo'wu'ning'ri	1
过隙白驹	guo'xi'bai'ju	1
过眼烟云	guo'yan'yan'yun	1
过犹不及	guo'you'bu'ji	1
果于自信	guo'yu'zi'xin	1
国之干城	guo'zhi'gan'cheng	1
裹足不前	guo'zu'bu'qian	1
海北天南	hai'bei'tian'nan	1
海不扬波	hai'bu'yang'bo	1
海底捞月	hai'di'lao'yue	1
海底捞针	hai'di'lao'zhen	1
海角天涯	hai'jiao'tian'ya	1
海枯见底	hai'ku'jian'di	1
海枯石烂	hai'ku'shi'lan	1
海阔天空	hai'kuo'tian'kong	1
海立云垂	hai'li'yun'chui	1
海纳百川	hai'na'bai'chuan	1
海内无双	hai'nei'wu'shuang	1
害群之马	hai'qun'zhi'ma	1
骇人听闻	hai'ren'ting'wen	1
海誓山盟	hai'shi'shan'meng	1
海市蜃楼	hai'shi'shen'lou	1
海水群飞	hai'shui'qun'fei	1
咳唾成珠	hai'tuo'cheng'zhu	1
海外奇谈	hai'wai'qi'tan	1
海屋添筹	hai'wu'tian'chou	1
海啸山崩	hai'xiao'shan'beng	1
海晏河清	hai'yan'he'qing	1
旱魃为虐	han'ba'wei'nve	1
含苞待放	han'bao'dai'fang	1
含苞欲放	han'bao'yu'fang	1
汗不敢出	han'bu'gan'chu	1
含哺鼓腹	han'bu'gu'fu	1
寒蝉凄切	han'chan'qi'qie	1
寒蝉仗马	han'chan'zhang'ma	1
酣畅淋漓	han'chang'lin'li	1
邯郸学步	han'dan'xue'bu	1
扞格不入	han'ge'bu'ru	1
酣歌恒舞	han'ge'heng'wu	1
寒耕热耘	han'geng're'yun	1
含垢藏疾	han'gou'cang'ji	1
含垢纳污	han'gou'na'wu	1
含垢忍辱	han'gou'ren'ru	1
汉官威仪	han'guan'wei'yi	1
含糊其词	han'hu'qi'ci	1
含糊其辞	han'hu'qi'ci	1
寒花晚节	han'hua'wan'jie	1
寒来暑往	han'lai'shu'wang	1
含蓼问疾	han'liao'wen'ji	1
汗流浃背	han'liu'jia'bei	1
韩卢逐块	han'lu'zhu'kuai	1
汗马功劳	han'ma'gong'lao	1
寒毛卓竖	han'mao'zhuo'shu	1
旱苗得雨	han'miao'de'yu	1
寒木春华	han'mu'chun'hua	1
汗牛充栋	han'niu'chong'dong	1
罕譬而喻	han'pi'er'yu	1
含情脉脉	han'qing'mo'mo	1
寒泉之思	han'quan'zhi'si	1
悍然不顾	han'ran'bu'gu	1
含沙射影	han'sha'she'ying	1
鼾声如雷	han'sheng'ru'lei	1
撼树蚍蜉	han'shu'bi'fu	1
寒酸落魄	han'suan'luo'po	1
含笑九泉	han'xiao'jiu'quan	1
含辛茹苦	han'xin'ru'ku	1
寒心酸鼻	han'xin'suan'bi	1
含血喷人	han'xue'pen'ren	1
罕言寡语	han'yan'gua'yu	1
汗颜无地	han'yan'wu'di	1
含饴弄孙	han'yi'nong'sun	1
含英咀华	han'ying'ju'hua	1
含冤负屈	han'yuan'fu'qu	1
喊冤叫屈	han'yuan'jiao'qu	1
憨状可掬	han'zhuang'ke'ju	1
行号巷哭	hang'hao'xiang'ku	1
蒿目时艰	hang'mu'shi'jian	1
沆瀣一气	hang'xie'yi'qi	1
毫不讳言	hao'bu'hui'yan	1
皓齿蛾眉	hao'chi'e'mei	1
好吃懒做	hao'chi'lan'zuo	1
皓齿明眸	hao'chi'ming'mou	1
好大喜功	hao'da'xi'gong	1
好丹非素	hao'dan'fei'su	1
毫发不爽	hao'fa'bu'shuang	1
豪放不羁	hao'fang'bu'ji	1
好高骛远	hao'gao'wu'yuan	1
号寒啼饥	hao'han'ti'ji	1
浩浩荡荡	hao'hao'dang'dang	1
好好先生	hao'hao'xian'sheng	1
好景不常	hao'jing'bu'chang	1
毫厘不爽	hao'li'bu'shuang	1
毫厘千里	hao'li'qian'li	1
濠梁之上	hao'liang'zhi'shang	1
豪门巨室	hao'men'ju'shi	1
好梦不长	hao'meng'bu'chang	1
好梦难成	hao'meng'nan'cheng	1
好谋善断	hao'mou'shan'duan	1
浩气长存	hao'qi'chang'cun	1
浩气凛然	hao'qi'lin'ran	1
豪情逸致	hao'qing'yi'zhi	1
豪情壮志	hao'qing'zhuang'zhi	1
浩然之气	hao'ran'zhi'qi	1
好肉剜疮	hao'rou'wan'chuang	1
浩如烟海	hao'ru'yan'hai	1
好色之徒	hao'se'zhi'tu	1
豪奢放逸	hao'she'fang'yi	1
好声好气	hao'sheng'hao'qi	1
好事多磨	hao'shi'duo'mo	1
好事之徒	hao'shi'zhi'tu	1
皓首苍颜	hao'shou'cang'yan	1
皓首穷经	hao'shou'qiong'jing	1
好说歹说	hao'shuo'dai'shuo	1
号咷大哭	hao'tao'da'ku	1
号啕大哭	hao'tao'da'ku	1
昊天罔极	hao'tian'wang'ji	1
好为人师	hao'wei'ren'shi	1
好为事端	hao'wei'shi'duan	1
好问决疑	hao'wen'jue'yi	1
好问则裕	hao'wen'ze'yu	1
毫无二致	hao'wu'er'zhi	1
毫无逊色	hao'wu'xun'se	1
毫无疑义	hao'wu'yi'yi	1
好行小惠	hao'xing'xiao'hui	1
好学不倦	hao'xue'bu'juan	1
豪言壮语	hao'yan'zhuang'yu	1
好逸恶劳	hao'yi'wu'lao	1
好勇斗狠	hao'yong'dou'hen	1
好语如珠	hao'yu'ru'zhu	1
皓月千里	hao'yue'qian'li	1
好整以暇	hao'zheng'yi'xia	1
好自为之	hao'zi'wei'zhi	1
好自为之	hao'zi'wei'zhi	1
和蔼可亲	he'ai'ke'qin	1
和璧隋珠	he'bi'sui'zhu	1
呵壁问天	he'bi'wen'tian	1
河东狮吼	he'dong'shi'hou	1
和而不唱	he'er'bu'chang	1
和而不同	he'er'bu'tong	1
合而为一	he'er'wei'yi	1
鹤发鸡皮	he'fa'ji'pi	1
鹤发童颜	he'fa'tong'yan	1
和风细雨	he'feng'xi'yu	1
呵佛骂祖	he'fo'ma'zu	1
和光同尘	he'guang'tong'chen	1
河汉无极	he'han'wu'ji	1
赫赫有名	he'he'you'ming	1
赫赫之功	he'he'zhi'gong	1
赫赫之光	he'he'zhi'guang	1
何患无辞	he'huan'wu'ci	1
何乐不为	he'le'bu'wei	1
鹤唳华亭	he'li'hua'ting	1
鹤立鸡群	he'li'ji'qun	1
河梁携手	he'liang'xie'shou	1
河梁之谊	he'liang'zhi'yi	1
河落海干	he'luo'hai'gan	1
鹤鸣九皋	he'ming'jiu'gao	1
鹤鸣之士	he'ming'zhi'shi	1
河目海口	he'mu'hai'kou	1
和睦相处	he'mu'xiang'chu	1
和盘托出	he'pan'tuo'chu	1
合浦珠还	he'pu'zhu'huan	1
何其毒也	he'qi'du'ye	1
和气致祥	he'qi'zhi'xiang	1
荷枪实弹	he'qiang'shi'dan	1
河清海晏	he'qing'hai'yan	1
河清难俟	he'qing'nan'si	1
何去何从	he'qu'he'cong	1
赫然而怒	he'ran'er'nu	1
和如琴瑟	he'ru'qin'se	1
河山带砺	he'shan'dai'li	1
喝西北风	he'xi'bei'feng	1
和颜悦色	he'yan'yue'se	1
褐衣不完	he'yi'bu'wan	1
和衣而卧	he'yi'er'wo	1
褐衣蔬食	he'yi'shu'shi	1
河鱼腹疾	he'yu'fu'ji	1
涸辙之鲋	he'zhe'zhi'fu	1
和衷共济	he'zhong'gong'ji	1
合从连衡	he'zong'lian'heng	1
何足道哉	he'zu'dao'zai	1
何足挂齿	he'zu'gua'chi	1
何足为奇	he'zu'wei'qi	1
何罪之有	he'zui'zhi'you	1
黑白分明	hei'bai'fen'ming	1
黑白混淆	hei'bai'hun'xiao	1
黑灯瞎火	hei'deng'xia'huo	1
黑更半夜	hei'geng'ban'ye	1
黑天摸地	hei'tian'mo'di	1
恨海难填	hen'hai'nan'tian	1
恨入骨髓	hen'ru'gu'sui	1
恨如头醋	hen'ru'tou'cu	1
恨相知晚	hen'xiang'zhi'wan	1
狠心辣手	hen'xin'la'shou	1
恨之入骨	hen'zhi'ru'gu	1
横冲直撞	heng'chong'zhi'zhuang	1
横峰侧岭	heng'feng'ce'ling	1
横赋暴敛	heng'fu'bao'lian	1
横戈跃马	heng'ge'yue'ma	1
恒河沙数	heng'he'sha'shu	1
亨嘉之会	heng'jia'zhi'hui	1
横蛮无理	heng'man'wu'li	1
横眉怒目	heng'mei'nu'mu	1
横眉竖眼	heng'mei'shu'yan	1
横七竖八	heng'qi'shu'ba	1
横扫千军	heng'sao'qian'jun	1
横生枝节	heng'sheng'zhi'jie	1
横槊赋诗	heng'shuo'fu'shi	1
横行霸道	heng'xing'ba'dao	1
横行不法	heng'xing'bu'fa	1
横行天下	heng'xing'tian'xia	1
横行无忌	heng'xing'wu'ji	1
横殃飞祸	heng'yang'fei'huo	1
衡阳雁断	heng'yang'yan'duan	1
横征暴敛	heng'zheng'bao'lian	1
红白喜事	hong'bai'xi'shi	1
红愁绿惨	hong'chou'lv'can	1
鸿毳沉舟	hong'cui'chen'zhou	1
哄动一时	hong'dong'yi'shi	1
红豆相思	hong'dou'xiang'si	1
鸿飞冥冥	hong'fei'ming'ming	1
红粉青楼	hong'fen'qing'lou	1
洪福齐天	hong'fu'qi'tian	1
轰轰烈烈	hong'hong'lie'lie	1
鸿鹄将至	hong'hu'jiang'zhi	1
鸿鹄之志	hong'hu'zhi'zhi	1
鸿渐之仪	hong'jian'zhi'yi	1
洪炉点雪	hong'lu'dian'xue	1
洪炉燎发	hong'lu'liao'fa	1
鸿毛泰山	hong'mao'tai'shan	1
红男绿女	hong'nan'lv'nv	1
鸿篇巨制	hong'pian'ju'zhi	1
红旗报捷	hong'qi'bao'jie	1
红情绿意	hong'qing'lv'yi	1
红日三竿	hong'ri'san'gan	1
鸿儒硕学	hong'ru'shuo'xue	1
红绳系足	hong'sheng'ji'zu	1
红衰翠减	hong'shuai'cui'jian	1
洪水横流	hong'shui'heng'liu	1
洪水猛兽	hong'shui'meng'shou	1
哄堂大笑	hong'tang'da'xiao	1
宏图大志	hong'tu'da'zhi	1
烘托渲染	hong'tuo'xuan'ran	1
鸿稀鳞绝	hong'xi'lin'jue	1
虹销雨霁	hong'xiao'yu'ji	1
红杏出墙	hong'xing'chu'qiang	1
鸿雁哀鸣	hong'yan'ai'ming	1
红颜薄命	hong'yan'bo'ming	1
红叶题诗	hong'ye'ti'shi	1
鸿业远图	hong'ye'yuan'tu	1
弘毅宽厚	hong'yi'kuan'hou	1
烘云托月	hong'yun'tuo'yue	1
闳中肆外	hong'zhong'si'wai	1
后车之戒	hou'che'zhi'jie	1
厚此薄彼	hou'ci'bo'bi	1
厚德载物	hou'de'zai'wu	1
后发制人	hou'fa'zhi'ren	1
后福无量	hou'fu'wu'liang	1
侯服玉食	hou'fu'yu'shi	1
厚古薄今	hou'gu'bo'jin	1
后顾之忧	hou'gu'zhi'you	1
后患无穷	hou'huan'wu'qiong	1
后悔无及	hou'hui'wu'ji	1
后会无期	hou'hui'wu'qi	1
后会有期	hou'hui'you'qi	1
厚积薄发	hou'ji'bo'fa	1
后继无人	hou'ji'wu'ren	1
后继有人	hou'ji'you'ren	1
厚今薄古	hou'jin'bo'gu	1
后来居上	hou'lai'ju'shang	1
后来之秀	hou'lai'zhi'xiu	1
厚貌深情	hou'mao'shen'qing	1
侯门如海	hou'men'ru'hai	1
侯门似海	hou'men'si'hai	1
后起之秀	hou'qi'zhi'xiu	1
后生可畏	hou'sheng'ke'wei	1
厚颜无耻	hou'yan'wu'chi	1
虎背熊腰	hu'bei'xiong'yao	1
呼不给吸	hu'bu'ji'xi	1
虎不食儿	hu'bu'shi'er	1
胡打海摔	hu'da'hai'shuai	1
虎斗龙争	hu'dou'long'zheng	1
怙恶不悛	hu'e'bu'quan	1
怙恩恃宠	hu'en'shi'chong	1
胡肥锺瘦	hu'fei'zhong'shou	1
呼风唤雨	hu'feng'huan'yu	1
胡服骑射	hu'fu'qi'she	1
户告人晓	hu'gao'ren'xiao	1
呼庚呼癸	hu'geng'hu'gui	1
湖光山色	hu'guang'shan'se	1
狐虎之威	hu'hu'zhi'wei	1
狐假虎威	hu'jia'hu'wei	1
壶浆塞道	hu'jiang'sai'dao	1
胡搅蛮缠	hu'jiao'man'chan	1
虎踞龙盘	hu'ju'long'pan	1
虎口拔牙	hu'kou'ba'ya	1
虎口逃生	hu'kou'tao'sheng	1
虎口余生	hu'kou'yu'sheng	1
虎狼之势	hu'lang'zhi'shi	1
瑚琏之器	hu'lian'zhi'qi	1
呼卢喝雉	hu'lu'he'zhi	1
囫囵半片	hu'lun'ban'pian	1
囫囵吞枣	hu'lun'tun'zao	1
虎落平川	hu'luo'ping'chuan	1
狐埋狐搰	hu'mai'hu'hu	1
呼牛呼马	hu'niu'hu'ma	1
狐朋狗友	hu'peng'gou'you	1
呼朋引类	hu'peng'yin'lei	1
狐凭鼠伏	hu'ping'shu'fu	1
虎珀拾芥	hu'po'shi'jie	1
狐裘羔袖	hu'qiu'gao'xiu	1
狐群狗党	hu'qun'gou'dang	1
虎入羊群	hu'ru'yang'qun	1
虎视眈眈	hu'shi'dan'dan	1
户枢不蠹	hu'shu'bu'du	1
胡说八道	hu'shuo'ba'dao	1
胡思乱想	hu'si'luan'xiang	1
狐死首丘	hu'si'shou'qiu	1
狐死兔泣	hu'si'tu'qi	1
虎体熊腰	hu'ti'xiong'yao	1
胡天胡帝	hu'tian'hu'di	1
呼天抢地	hu'tian'qiang'di	1
互通有无	hu'tong'you'wu	1
虎头虎脑	hu'tou'hu'nao	1
虎头蛇尾	hu'tou'she'wei	1
虎头燕颔	hu'tou'yan'han	1
狐兔之悲	hu'tu'zhi'bei	1
互为表里	hu'wei'biao'li	1
虎尾春冰	hu'wei'chun'bing	1
互为因果	hu'wei'yin'guo	1
虎卧龙跳	hu'wo'long'tiao	1
呼吸相通	hu'xi'xiang'tong	1
呼吸之间	hu'xi'zhi'jian	1
户限为穿	hu'xian'wei'chuan	1
互相标榜	hu'xiang'biao'bang	1
互相推诿	hu'xiang'tui'wei	1
虎啸风生	hu'xiao'feng'sheng	1
虎穴龙潭	hu'xue'long'tan	1
胡言乱语	hu'yan'luan'yu	1
呼幺喝六	hu'yao'he'liu	1
狐疑不决	hu'yi'bu'jue	1
胡越之祸	hu'yue'zhi'huo	1
呼之欲出	hu'zhi'yu'chu	1
壶中日月	hu'zhong'ri'yue	1
胡作非为	hu'zuo'fei'wei	1
画饼充饥	hua'bing'chong'ji	1
话不投机	hua'bu'tou'ji	1
华不再扬	hua'bu'zai'yang	1
花残月缺	hua'can'yue'que	1
画地而趋	hua'di'er'qu	1
画荻教子	hua'di'jiao'zi	1
画地刻木	hua'di'ke'mu	1
画地为牢	hua'di'wei'lao	1
画栋雕梁	hua'dong'diao'liang	1
华而不实	hua'er'bu'shi	1
华冠丽服	hua'guan'li'fu	1
花好月圆	hua'hao'yue'yuan	1
花红柳绿	hua'hong'liu'lv	1
画虎成狗	hua'hu'cheng'gou	1
画虎类狗	hua'hu'lei'gou	1
花花公子	hua'hua'gong'zi	1
花花世界	hua'hua'shi'jie	1
花花太岁	hua'hua'tai'sui	1
花甲之年	hua'jia'zhi'nian	1
花街柳巷	hua'jie'liu'xiang	1
花里胡哨	hua'li'hu'shao	1
话里有话	hua'li'you'hua	1
画梁雕栋	hua'liang'diao'dong	1
化零为整	hua'ling'wei'zheng	1
画龙点睛	hua'long'dian'jing	1
画眉举案	hua'mei'ju'an	1
花前月下	hua'qian'yue'xia	1
花容月貌	hua'rong'yue'mao	1
画沙印泥	hua'sha'yin'ni	1
画蛇添足	hua'she'tian'zu	1
花说柳说	hua'shuo'liu'shuo	1
花天酒地	hua'tian'jiu'di	1
华亭鹤唳	hua'ting'he'li	1
花团锦簇	hua'tuan'jin'cu	1
化外之民	hua'wai'zhi'min	1
化为乌有	hua'wei'wu'you	1
华屋秋墟	hua'wu'qiu'xu	1
华屋山丘	hua'wu'shan'qiu	1
花下晒裈	hua'xia'shai'kun	1
化险为夷	hua'xian'wei'yi	1
花香鸟语	hua'xiang'niao'yu	1
花言巧语	hua'yan'qiao'yu	1
花颜月貌	hua'yan'yue'mao	1
花样翻新	hua'yang'fan'xin	1
划一不二	hua'yi'bu'er	1
花朝月夕	hua'zhao'yue'xi	1
花遮柳隐	hua'zhe'liu'yin	1
化整为零	hua'zheng'wei'ling	1
画脂镂冰	hua'zhi'lou'bing	1
花枝招展	hua'zhi'zhao'zhan	1
哗众取宠	hua'zhong'qu'chong	1
话中有话	hua'zhong'you'hua	1
画中有诗	hua'zhong'you'shi	1
怀宝迷邦	huai'bao'mi'bang	1
怀璧其罪	huai'bi'qi'zui	1
怀才不遇	huai'cai'bu'yu	1
怀敌附远	huai'di'fu'yuan	1
怀恨在心	huai'hen'zai'xin	1
怀瑾握瑜	huai'jin'wo'yu	1
淮橘为枳	huai'ju'wei'zhi	1
淮南鸡犬	huai'nan'ji'quan	1
怀铅提椠	huai'qian'ti'qian	1
坏人心术	huai'ren'xin'shu	1
怀土之情	huai'tu'zhi'qing	1
怀冤抱屈	huai'yuan'bao'qu	1
怀着鬼胎	huai'zhe'gui'tai	1
欢蹦乱跳	huan'beng'luan'tiao	1
缓兵之计	huan'bing'zhi'ji	1
缓步代车	huan'bu'dai'che	1
缓不济急	huan'bu'ji'ji	1
还淳返朴	huan'chun'fan'pu	1
患得患失	huan'de'huan'shi	1
换斗移星	huan'dou'yi'xing	1
环堵萧然	huan'du'xiao'ran	1
环肥燕瘦	huan'fei'yan'shou	1
宦海风波	huan'hai'feng'bo	1
欢呼雀跃	huan'hu'que'yue	1
缓急轻重	huan'ji'qing'zhong	1
缓急相济	huan'ji'xiang'ji	1
擐甲执兵	huan'jia'zhi'bing	1
欢聚一堂	huan'ju'yi'tang	1
患难夫妻	huan'nan'fu'qi	1
患难与共	huan'nan'yu'gong	1
患难之交	huan'nan'zhi'jiao	1
涣然冰释	huan'ran'bing'shi	1
焕然一新	huan'ran'yi'xin	1
欢声雷动	huan'sheng'lei'dong	1
欢天喜地	huan'tian'xi'di	1
还我河山	huan'wo'he'shan	1
欢喜冤家	huan'xi'yuan'jia	1
欢欣鼓舞	huan'xin'gu'wu	1
欢欣若狂	huan'xin'ruo'kuang	1
患至呼天	huan'zhi'hu'tian	1
慌不择路	huang'bu'ze'lu	1
潢池弄兵	huang'chi'nong'bing	1
荒诞不经	huang'dan'bu'jing	1
荒诞无稽	huang'dan'wu'ji	1
黄道吉日	huang'dao'ji'ri	1
黄耳传书	huang'er'chuan'shu	1
黄发垂髫	huang'fa'chui'tiao	1
黄发儿齿	huang'fa'er'chi	1
黄公酒垆	huang'gong'jiu'lu	1
黄河水清	huang'he'shui'qing	1
黄花晚节	huang'hua'wan'jie	1
黄金时代	huang'jin'shi'dai	1
黄金铸象	huang'jin'zhu'xiang	1
黄卷青灯	huang'juan'qing'deng	1
黄卷幼妇	huang'juan'you'fu	1
惶恐不安	huang'kong'bu'an	1
黄口孺子	huang'kou'ru'zi	1
黄口小儿	huang'kou'xiao'er	1
黄梁美梦	huang'liang'mei'meng	1
黄梁一梦	huang'liang'yi'meng	1
黄垆之痛	huang'lu'zhi'tong	1
黄绵袄子	huang'mian'ao'zi	1
荒谬绝伦	huang'miu'jue'lun	1
黄袍加身	huang'pao'jia'shen	1
黄旗紫盖	huang'qi'zi'gai	1
皇亲国戚	huang'qin'guo'qi	1
黄泉之下	huang'quan'zhi'xia	1
黄雀伺蝉	huang'que'si'chan	1
黄雀衔环	huang'que'xian'huan	1
恍然大悟	huang'ran'da'wu	1
恍然若失	huang'ran'ruo'shi	1
恍如隔世	huang'ru'ge'shi	1
恍如梦境	huang'ru'meng'jing	1
荒时暴月	huang'shi'bao'yue	1
慌手慌脚	huang'shou'huang'jiao	1
黄台之瓜	huang'tai'zhi'gua	1
皇天后土	huang'tian'hou'tu	1
黄童白叟	huang'tong'bai'sou	1
荒无人烟	huang'wu'ren'yan	1
黄杨厄闰	huang'yang'e'run	1
荒淫无耻	huang'yin'wu'chi	1
荒淫无度	huang'yin'wu'du	1
黄钟大吕	huang'zhong'da'lv	1
黄钟毁弃	huang'zhong'hui'qi	1
黄钟瓦釜	huang'zhong'wa'fu	1
悔不当初	hui'bu'dang'chu	1
回肠荡气	hui'chang'dang'qi	1
回肠九转	hui'chang'jiu'zhuan	1
喙长三尺	hui'chang'san'chi	1
回嗔作喜	hui'chen'zuo'xi	1
挥斥八极	hui'chi'ba'ji	1
回船转舵	hui'chuan'zhan'duo	1
荟萃一堂	hui'cui'yi'tang	1
诲盗诲淫	hui'dao'hui'yin	1
悔读南华	hui'du'nan'hua	1
惠而不费	hui'er'bu'fei	1
灰飞烟灭	hui'fei'yan'mie	1
惠风和畅	hui'feng'he'chang	1
会逢其适	hui'feng'qi'shi	1
隳肝沥胆	hui'gan'li'dan	1
挥戈反日	hui'ge'fan'ri	1
回光返照	hui'guang'fan'zhao	1
辉光日新	hui'guang'ri'xin	1
悔过自新	hui'guo'zi'xin	1
挥汗成雨	hui'han'cheng'yu	1
挥翰临池	hui'han'lin'chi	1
挥汗如雨	hui'han'ru'yu	1
挥毫落纸	hui'hao'luo'zhi	1
悔恨交加	hui'hen'jiao'jia	1
回黄转绿	hui'huang'zhuan'lv	1
恢恢有余	hui'hui'you'yu	1
挥霍无度	hui'huo'wu'du	1
讳疾忌医	hui'ji'ji'yi	1
晦迹韬光	hui'ji'tao'guang	1
毁家纾难	hui'jia'shu'nan	1
挥金如土	hui'jin'ru'tu	1
恢廓大度	hui'kuo'da'du	1
贿赂公行	hui'lu'gong'xing	1
讳莫如深	hui'mo'ru'shen	1
回眸一笑	hui'mou'yi'xiao	1
惠然肯来	hui'ran'ken'lai	1
诲人不倦	hui'ren'bu'juan	1
挥洒自如	hui'sa'zi'ru	1
回山倒海	hui'shan'dao'hai	1
绘声绘色	hui'sheng'hui'se	1
绘声绘影	hui'sheng'hui'ying	1
彗汜画涂	hui'si'hua'tu	1
回天乏术	hui'tian'fa'shu	1
回天之力	hui'tian'zhi'li	1
回头是岸	hui'tou'shi'an	1
灰头土面	hui'tou'tu'mian	1
回味无穷	hui'wei'wu'qiong	1
灰心槁形	hui'xin'gao'xing	1
蕙心兰质	hui'xin'lan'zhi	1
灰心丧气	hui'xin'sang'qi	1
蕙心纨质	hui'xin'wan'zhi	1
回心转意	hui'xin'zhuan'yi	1
秽言污语	hui'yan'wu'yu	1
慧业文人	hui'ye'wen'ren	1
诲淫诲盗	hui'yin'hui'dao	1
绘影绘声	hui'ying'hui'sheng	1
毁誉不一	hui'yu'bu'yi	1
毁誉参半	hui'yu'can'ban	1
毁于一旦	hui'yu'yi'dan	1
悔之不及	hui'zhi'bu'ji	1
悔之无及	hui'zhi'wu'ji	1
魂不附体	hun'bu'fu'ti	1
魂不守舍	hun'bu'shou'she	1
昏定晨省	hun'ding'chen'xing	1
混沌不分	hun'dun'bu'fen	1
魂飞魄散	hun'fei'po'san	1
魂飞天外	hun'fei'tian'wai	1
浑浑噩噩	hun'hun'e'e	1
昏昏欲睡	hun'hun'yu'shui	1
浑金璞玉	hun'jin'pu'yu	1
昏镜重磨	hun'jing'chong'mo	1
昏聩无能	hun'kui'wu'neng	1
魂牵梦萦	hun'qian'meng'ying	1
浑然天成	hun'ran'tian'cheng	1
浑然无知	hun'ran'wu'zhi	1
浑然一体	hun'ran'yi'ti	1
混然一体	hun'ran'yi'ti	1
浑身是胆	hun'shen'shi'dan	1
浑身解数	hun'shen'xie'shu	1
混世魔王	hun'shi'mo'wang	1
浑水摸鱼	hun'shui'mo'yu	1
混水摸鱼	hun'shui'mo'yu	1
浑俗和光	hun'su'he'guang	1
昏天黑地	hun'tian'hei'di	1
昏头昏脑	hun'tou'hun'nao	1
魂亡魄失	hun'wang'po'shi	1
混为一谈	hun'wei'yi'tan	1
混淆黑白	hun'xiao'hei'bai	1
混淆是非	hun'xiao'shi'fei	1
混淆视听	hun'xiao'shi'ting	1
混应滥应	hun'ying'lan'ying	1
昏庸无道	hun'yong'wu'dao	1
祸不单行	huo'bu'dan'xing	1
祸不旋踵	huo'bu'xuan'zhong	1
祸从口出	huo'cong'kou'chu	1
祸从天降	huo'cong'tian'jiang	1
豁达大度	huo'da'da'du	1
祸福无常	huo'fu'wu'chang	1
祸福无门	huo'fu'wu'men	1
祸福相生	huo'fu'xiang'sheng	1
祸福相依	huo'fu'xiang'yi	1
祸福倚伏	huo'fu'yi'fu	1
火耕水耨	huo'geng'shui'nou	1
火光烛天	huo'guang'zhu'tian	1
祸国殃民	huo'guo'yang'min	1
火海刀山	huo'hai'dao'shan	1
祸结兵连	huo'jie'bing'lian	1
祸绝福连	huo'jue'fu'lian	1
活灵活现	huo'ling'huo'xian	1
活龙活现	huo'long'huo'xian	1
火冒三丈	huo'mao'san'zhang	1
祸起萧墙	huo'qi'xiao'qiang	1
蠖屈求伸	huo'qu'qiu'shen	1
霍然而愈	huo'ran'er'yu	1
豁然贯通	huo'ran'guan'tong	1
豁然开朗	huo'ran'kai'lang	1
火然泉达	huo'ran'quan'da	1
火伞高张	huo'san'gao'zhang	1
火上浇油	huo'shang'jiao'you	1
火上弄冰	huo'shang'nong'bing	1
火烧火燎	huo'shao'huo'liao	1
火烧眉毛	huo'shao'mei'mao	1
祸首罪魁	huo'shou'zui'kui	1
火树银花	huo'shu'yin'hua	1
祸为福先	huo'wei'fu'xian	1
火眼金睛	huo'yan'jin'jing	1
祸在旦夕	huo'zai'dan'xi	1
祸枣灾梨	huo'zao'zai'li	1
货真价实	huo'zhen'jia'shi	1
火中取栗	huo'zhong'qu'li	1
积案盈箱	ji'an'ying'xiang	1
激昂慷慨	ji'ang'kang'kai	1
机变如神	ji'bian'ru'shen	1
及宾有鱼	ji'bin'you'yu	1
激薄停浇	ji'bo'ting'jiao	1
急不可待	ji'bu'ke'dai	1
疾不可为	ji'bu'ke'wei	1
急不暇择	ji'bu'xia'ze	1
积不相能	ji'bu'xiang'neng	1
计不旋踵	ji'bu'xuan'zhong	1
季布一诺	ji'bu'yi'nuo	1
饥不择食	ji'bu'ze'shi	1
饥餐渴饮	ji'can'ke'yin	1
积草屯粮	ji'cao'tun'liang	1
掎裳连袂	ji'chang'lian'mei	1
饥肠辘辘	ji'chang'lu'lu	1
季常之癖	ji'chang'zhi'pi	1
既成事实	ji'cheng'shi'shi	1
急赤白脸	ji'chi'bai'lian	1
鸡虫得失	ji'chong'de'shi	1
计出万全	ji'chu'wan'quan	1
计出无聊	ji'chu'wu'liao	1
几次三番	ji'ci'san'fan	1
积德累功	ji'de'lei'gong	1
积德累仁	ji'de'lei'ren	1
及第成名	ji'di'cheng'ming	1
际地蟠天	ji'di'pan'tian	1
疾恶如仇	ji'e'ru'chou	1
极而言之	ji'er'yan'zhi	1
积非成是	ji'fei'cheng'shi	1
鸡飞蛋打	ji'fei'dan'da	1
鸡飞狗走	ji'fei'gou'zou	1
激忿填膺	ji'fen'tian'ying	1
急风暴雨	ji'feng'bao'yu	1
箕风毕雨	ji'feng'bi'yu	1
及锋而试	ji'feng'er'shi	1
稷蜂社鼠	ji'feng'she'shu	1
疾风迅雷	ji'feng'xun'lei	1
饥附饱飏	ji'fu'bao'yang	1
纪纲人论	ji'gang'ren'lun	1
计功补过	ji'gong'bu'guo	1
急公好义	ji'gong'hao'yi	1
急公近利	ji'gong'jin'li	1
急功近利	ji'gong'jin'li	1
计功行赏	ji'gong'xing'shang	1
积谷防饥	ji'gu'fang'ji	1
击鼓鸣金	ji'gu'ming'jin	1
鸡骨支床	ji'gu'zhi'chuang	1
及瓜而代	ji'gua'er'dai	1
急管繁弦	ji'guan'fan'xian	1
机关算尽	ji'guan'suan'jin	1
机关用尽	ji'guan'yong'jin	1
吉光片羽	ji'guang'pian'yu	1
继晷焚膏	ji'gui'fen'gao	1
计过自讼	ji'guo'zi'song	1
饥寒交迫	ji'han'jiao'po	1
济寒赈贫	ji'han'zhen'pin	1
济河焚舟	ji'he'fen'zhou	1
积厚流光	ji'hou'liu'guang	1
积毁销骨	ji'hui'xiao'gu	1
瘠己肥人	ji'ji'fei'ren	1
己饥己溺	ji'ji'ji'ni	1
岌岌可危	ji'ji'ke'wei	1
及笄年华	ji'ji'nian'hua	1
济济一堂	ji'ji'yi'tang	1
击楫中流	ji'ji'zhong'liu	1
积甲山齐	ji'jia'shan'qi	1
计将安出	ji'jiang'an'chu	1
掎角之势	ji'jiao'zhi'shi	1
击节称赏	ji'jie'cheng'shang	1
击节叹赏	ji'jie'tan'shang	1
即景生情	ji'jing'sheng'qing	1
继绝存亡	ji'jue'cun'wang	1
鸡口牛后	ji'kou'niu'hou	1
济苦怜贫	ji'ku'lian'pin	1
济困扶危	ji'kun'fu'wei	1
积劳成疾	ji'lao'cheng'ji	1
极乐世界	ji'le'shi'jie	1
赍粮藉寇	ji'liang'jie'kou	1
鸡零狗碎	ji'ling'gou'sui	1
急流勇进	ji'liu'yong'jin	1
急流勇退	ji'liu'yong'tui	1
即鹿无虞	ji'lu'wu'yu	1
季路一言	ji'lu'yi'yan	1
急脉缓灸	ji'mai'huan'jiu	1
鸡毛蒜皮	ji'mao'suan'pi	1
挤眉弄眼	ji'mei'nong'yan	1
季孟之间	ji'meng'zhi'jian	1
鸡鸣而起	ji'ming'er'qi	1
鸡鸣狗盗	ji'ming'gou'dao	1
鸡鸣狗吠	ji'ming'gou'fei	1
鸡鸣戒旦	ji'ming'jie'dan	1
极目迥望	ji'mu'jiong'wang	1
极目远眺	ji'mu'yuan'tiao	1
积年累月	ji'nian'lei'yue	1
鸡皮鹤发	ji'pi'he'fa	1
急起直追	ji'qi'zhi'zhui	1
掎挈伺诈	ji'qie'si'zha	1
畸轻畸重	ji'qing'ji'zhong	1
计穷力竭	ji'qiong'li'jie	1
计穷力屈	ji'qiong'li'qu	1
佶屈聱牙	ji'qu'ao'ya	1
鸡犬不惊	ji'quan'bu'jing	1
鸡犬不留	ji'quan'bu'liu	1
鸡犬不宁	ji'quan'bu'ning	1
鸡犬皆仙	ji'quan'jie'xian	1
鸡犬桑麻	ji'quan'sang'ma	1
鸡犬升天	ji'quan'sheng'tian	1
纪群之交	ji'qun'zhi'jiao	1
寂然不动	ji'ran'bu'dong	1
瘠人肥己	ji'ren'fei'ji	1
寄人篱下	ji'ren'li'xia	1
吉人天相	ji'ren'tian'xiang	1
急人之难	ji'ren'zhi'nan	1
计日程功	ji'ri'cheng'gong	1
计日而待	ji'ri'er'dai	1
积日累久	ji'ri'lei'jiu	1
吉日良辰	ji'ri'liang'chen	1
疾如雷电	ji'ru'lei'dian	1
急如星火	ji'ru'xing'huo	1
疾如旋踵	ji'ru'xuan'zhong	1
济弱锄强	ji'ruo'chu'qiang	1
济弱扶倾	ji'ruo'fu'qing	1
寂若无人	ji'ruo'wu'ren	1
积沙成塔	ji'sha'cheng'ta	1
积善成德	ji'shan'cheng'de	1
积善余庆	ji'shan'yu'qing	1
计上心来	ji'shang'xin'lai	1
积少成多	ji'shao'cheng'duo	1
极深研幾	ji'shen'yan'ji	1
鸡声鹅斗	ji'sheng'e'dou	1
计深虑远	ji'sheng'lv'yuan	1
济世安邦	ji'shi'an'bang	1
济世安人	ji'shi'an'ren	1
济世救人	ji'shi'jiu'ren	1
济世匡时	ji'shi'kuang'shi	1
鸡尸牛从	ji'shi'niu'cong	1
虮虱相吊	ji'shi'xieng'diao	1
及时行乐	ji'shi'xing'le	1
济世之才	ji'shi'zhi'cai	1
疾首蹙额	ji'shou'cu'e	1
积水成渊	ji'shui'cheng'yuan	1
集思广益	ji'si'guang'yi	1
击碎唾壶	ji'sui'tuo'hu	1
季孙之忧	ji'sun'zhi'you	1
极天际地	ji'tian'ji'di	1
寂天寞地	ji'tian'mo'di	1
鸡头鱼刺	ji'tou'yu'ci	1
既往不咎	ji'wang'bu'jiu	1
继往开来	ji'wang'kai'lai	1
积微成著	ji'wei'cheng'zhu	1
记问之学	ji'wen'zhi'xue	1
计无付之	ji'wu'fu'zhi	1
计无所出	ji'wu'suo'chu	1
计无所施	ji'wu'suo'shi	1
鸡鹜相争	ji'wu'xiang'zheng	1
鸡鹜争食	ji'wu'zheng'shi	1
积习难改	ji'xi'nan'gai	1
嫉闲妒能	ji'xian'du'neng	1
吉祥如意	ji'xiang'ru'yi	1
吉祥止止	ji'xiang'zhi'zhi	1
积薪厝火	ji'xin'cuo'huo	1
吉星高照	ji'xing'gao'zhao	1
寄兴寓情	ji'xing'yu'qing	1
即兴之作	ji'xing'zhi'zuo	1
鸡胸龟背	ji'xiong'gui'bei	1
吉凶未卜	ji'xiong'wei'bu	1
疾言遽色	ji'yan'ju'se	1
疾言厉色	ji'yan'li'se	1
集腋成裘	ji'ye'cheng'qiu	1
记忆犹新	ji'yi'you'xin	1
急景凋年	ji'ying'diao'nian	1
饥鹰饿虎	ji'ying'e'hu	1
季友伯兄	ji'you'bo'xiong	1
积忧成疾	ji'you'cheng'ji	1
积羽沉舟	ji'yu'chen'zhou	1
积玉堆金	ji'yu'dui'jin	1
急于求成	ji'yu'qiu'cheng	1
急于事功	ji'yu'shi'gong	1
急于星火	ji'yu'xing'huo	1
集苑集枯	ji'yuan'ji'ku	1
急张拘诸	ji'zhang'ju'zhu	1
赍志而没	ji'zhi'er'mo	1
戟指怒目	ji'zhi'nu'zhang	1
积重难返	ji'zhong'nan'fan	1
急中生智	ji'zhong'sheng'zhi	1
击筑悲歌	ji'zhu'bei'ge	1
积铢累寸	ji'zhu'lei'cun	1
机杼一家	ji'zhu'yi'jia	1
急转直下	ji'zhuan'zhi'xia	1
激浊扬清	ji'zhuo'yang'qing	1
骥子龙文	ji'zi'long'wen	1
疾足先得	ji'zu'xian'de	1
家常便饭	jia'chang'bian'fan	1
家长里短	jia'chang'li'duan	1
假痴不癫	jia'chi'bu'dian	1
夹袋人物	jia'dai'ren'wu	1
家道从容	jia'dao'cong'rong	1
家道中落	jia'dao'zhong'luo	1
甲第连天	jia'di'lian'tian	1
佳儿佳妇	jia'er'jia'fu	1
家翻宅乱	jia'fan'zhai'luan	1
葭莩之亲	jia'fu'zhi'qin	1
假公济私	jia'gong'ji'si	1
加官进爵	jia'guan'jin'jue	1
甲冠天下	jia'guan'tian'xia	1
架海金梁	jia'hai'jin'liang	1
嫁祸于人	jia'huo'yu'ren	1
家给民足	jia'ji'min'zu	1
家给人足	jia'ji'ren'zu	1
家鸡野鹜	jia'ji'ye'wu	1
家鸡野雉	jia'ji'ye'zhi	1
家家户户	jia'jia'hu'hu	1
家见户说	jia'jian'hu'shuo	1
假力于人	jia'li'yu'ren	1
价廉物美	jia'lian'wu'mei	1
家贫亲老	jia'pin'qin'lao	1
家贫如洗	jia'pin'ru'xi	1
家破人亡	jia'po'ren'wang	1
夹七夹八	jia'qi'jia'ba	1
夹枪带棍	jia'qiang'dai'gun	1
驾轻就熟	jia'qing'jiu'shu	1
戛然而止	jia'ran'er'zhi	1
佳人才子	jia'ren'cai'zi	1
假人假义	jia'ren'jia'yi	1
假仁假义	jia'ren'jia'yi	1
加人一等	jia'ren'yi'deng	1
稼穑艰难	jia'se'jian'nan	1
颊上三毛	jia'shang'san'mao	1
颊上添毫	jia'shang'tian'hao	1
假手于人	jia'shou'yu'ren	1
浃髓沦肌	jia'sui'lun'ji	1
假途灭虢	jia'tu'mie'guo	1
家徒四壁	jia'tu'si'bi	1
家无儋石	jia'wu'dan'shi	1
架屋迭床	jia'wu'die'chuang	1
家无二主	jia'wu'er'zhu	1
加膝坠渊	jia'xi'zhui'yuan	1
家弦户诵	jia'xian'hu'song	1
家学渊源	jia'xue'yuan'yuan	1
嘉言懿行	jia'yan'yi'xing	1
假以辞色	jia'yi'ci'se	1
假誉驰声	jia'yu'chi'sheng	1
家喻户晓	jia'yu'hu'xiao	1
戛玉敲金	jia'yu'qiao'jin	1
家贼难防	jia'zei'nan'fang	1
价增一顾	jia'zeng'yi'gu	1
价值连城	jia'zhi'lian'cheng	1
见鞍思马	jian'an'si'ma	1
剑拔弩张	jian'ba'nu'zhang	1
坚壁清野	jian'bi'qing'yie	1
坚不可摧	jian'bu'ke'cui	1
间不容发	jian'bu'rong'fa	1
间不容息	jian'bu'rong'xi	1
健步如飞	jian'bu'ru'fei	1
箭不虚发	jian'bu'xu'fa	1
见财起意	jian'cai'qi'yi	1
剪草除根	jian'cao'chu'gen	1
兼程前进	jian'cheng'qian'jin	1
坚持不懈	jian'chi'bu'xie	1
坚持不渝	jian'chi'bu'yu	1
剑胆琴心	jian'dan'qin'xin	1
见弹求鸮	jian'dan'qiu'hao	1
坚定不移	jian'ding'bu'yi	1
见多识广	jian'duo'shi'guang	1
剪恶除奸	jian'e'chu'jian	1
兼而有之	jian'er'you'zhi	1
剪发杜门	jian'fa'du'men	1
见缝插针	jian'feng'cha'zhen	1
见风使舵	jian'feng'shi'duo	1
见风是雨	jian'feng'shi'yu	1
见风转舵	jian'feng'zhuan'duo	1
拣佛烧香	jian'fo'shao'xiang	1
建功立业	jian'gong'li'ye	1
俭故能广	jian'gu'neng'guang	1
见怪不怪	jian'guai'bu'guai	1
见机而行	jian'ji'er'xing	1
见几而作	jian'ji'er'zuo	1
见机而作	jian'ji'er'zuo	1
剑及屦及	jian'ji'ju'ji	1
剑戟森森	jian'ji'sen'sen	1
见机行事	jian'ji'xing'shi	1
坚甲利兵	jian'jia'li'bing	1
蒹葭伊人	jian'jia'yi'ren	1
蒹葭之思	jian'jia'zhi'si	1
简截了当	jian'jie'liao'dang	1
见景生情	jian'jing'sheng'qing	1
拣精择肥	jian'jing'ze'fei	1
见可而进	jian'ke'er'jin	1
俭可养廉	jian'ke'yang'lian	1
缄口结舌	jian'kou'jie'she	1
艰苦奋斗	jian'ku'fen'dou	1
艰苦朴素	jian'ku'pu'su	1
坚苦卓绝	jian'ku'zhuo'jue	1
艰苦卓绝	jian'ku'zhuo'jue	1
见利思义	jian'li'si'yi	1
见利忘义	jian'li'wang'yi	1
贱敛贵出	jian'lian'gui'chu	1
见猎心喜	jian'lie'xin'xi	1
见貌辨色	jian'mao'bian'se	1
鉴貌辨色	jian'mao'bian'se	1
简明扼要	jian'ming'e'yao	1
肩摩毂击	jian'mo'gu'ji	1
肩摩踵接	jian'mo'zhong'jie	1
艰难竭蹶	jian'nan'jie'jue	1
艰难困苦	jian'nan'kun'ku	1
艰难险阻	jian'nan'xian'zu	1
简能而任	jian'neng'er'ren	1
见弃于人	jian'qi'yu'ren	1
见钱眼开	jian'qian'yan'kai	1
坚强不屈	jian'qiang'bu'qu	1
见墙见羹	jian'qiang'jian'geng	1
兼权熟计	jian'quan'shu'ji	1
见雀张罗	jian'que'zhang'luo	1
坚忍不拔	jian'ren'bu'ba	1
坚韧不拔	jian'ren'bu'ba	1
见仁见智	jian'ren'jian'zhi	1
兼容并包	jian'rong'bing'bao	1
渐入佳境	jian'ru'jia'jing	1
坚如磐石	jian'ru'pan'shi	1
兼弱攻昧	jian'ruo'gong'mei	1
见善必迁	jian'shan'bi'qian	1
僭赏滥刑	jian'shang'lan'xing	1
见豕负涂	jian'shi'fu'tu	1
兼收并蓄	jian'shou'bing'xu	1
坚守不渝	jian'shou'bu'yu	1
监守自盗	jian'shou'zi'dao	1
剑树刀山	jian'shu'dao'shan	1
见死不救	jian'si'bu'jiu	1
茧丝牛毛	jian'si'niu'mao	1
尖酸刻薄	jian'suan'ke'bo	1
见所未见	jian'suo'wei'jian	1
剑头一吷	jian'tou'yi'xue	1
见兔放鹰	jian'tu'fang'ying	1
见兔顾犬	jian'tu'gu'quan	1
鉴往知来	jian'wang'zhi'lai	1
见危授命	jian'wei'shou'ming	1
见微知萌	jian'wei'zhi'meng	1
见微知著	jian'wei'zhi'zhu	1
见贤思齐	jian'xian'si'qi	1
见笑大方	jian'xiao'da'fang	1
见性成佛	jian'xing'cheng'fo	1
简要不烦	jian'yao'bu'fan	1
见异思迁	jian'yi'si'qian	1
俭以养德	jian'yi'yang'de	1
见义勇为	jian'yi'yong'wei	1
奸淫掳掠	jian'yin'lu'lve	1
鉴影度形	jian'ying'du'xing	1
箭在弦上	jian'zai'xian'shang	1
坚贞不屈	jian'zhen'bu'qu	1
谏争如流	jian'zheng'ru'liu	1
剪烛西窗	jian'zhu'xi'chuang	1
尖嘴薄舌	jian'zui'bo'she	1
尖嘴猴腮	jian'zui'hou'sai	1
将错就错	jiang'cuo'jiu'cuo	1
江东父老	jiang'dong'fu'lao	1
将夺固与	jiang'duo'gu'yu	1
降格以求	jiang'ge'yi'qiu	1
将功补过	jiang'gong'bu'guo	1
将功赎罪	jiang'gong'shu'zui	1
将功折罪	jiang'gong'zhe'zui	1
降贵纡尊	jiang'gui'yu'zun	1
姜桂之性	jiang'gui'zhi'xing	1
江汉朝宗	jiang'han'chao'zong	1
江河日下	jiang'he'ri'xia	1
江河行地	jiang'he'xing'di	1
将机就机	jiang'ji'jiu'ji	1
将计就计	jiang'ji'jiu'ji	1
讲经说法	jiang'jing'shuo'fa	1
浆酒霍肉	jiang'jiu'huo'rou	1
江郎才尽	jiang'lang'cai'jin	1
将门虎子	jiang'men'hu'zi	1
将门有将	jiang'men'you'jiang	1
将勤补拙	jiang'qin'bu'zhuo	1
江山如故	jiang'shan'ru'gu	1
江山如画	jiang'shan'ru'hua	1
匠石运金	jiang'shi'yun'jin	1
江天一色	jiang'tian'yi'se	1
将相之器	jiang'xiang'zhi'qi	1
将心比心	jiang'xin'bi'xin	1
江心补漏	jiang'xin'bu'lou	1
匠心独运	jiang'xin'du'yun	1
将信将疑	jiang'xin'jiang'yi	1
降心相从	jiang'xin'xiang'cong	1
讲信修睦	jiang'xin'xiu'mu	1
江洋大盗	jiang'yang'da'dao	1
将遇良材	jiang'yu'liang'cai	1
降志辱身	jiang'zhi'ru'shen	1
降尊临卑	jiang'zun'lin'bei	1
焦熬投石	jiao'ao'tou'shi	1
骄傲自满	jiao'ao'zi'man	1
交臂历指	jiao'bi'li'zhi	1
交臂失之	jiao'bi'shi'zhi	1
骄兵必败	jiao'bing'bi'bai	1
骄兵之计	jiao'bing'zhi'ji	1
脚不点地	jiao'bu'dian'di	1
交淡若水	jiao'dan'ruo'shui	1
搅海翻江	jiao'hai'fan'jiang	1
郊寒岛瘦	jiao'han'dao'shou	1
矫矫不群	jiao'jiao'bu'qun	1
绞尽脑汁	jiao'jin'nao'zhi	1
焦金烁石	jiao'jin'shuo'shi	1
角巾私第	jiao'jin'si'di	1
交口称誉	jiao'kou'cheng'yu	1
叫苦不迭	jiao'ku'bu'die	1
叫苦连天	jiao'ku'lian'tian	1
交梨火枣	jiao'li'huo'zao	1
鹪鹩一枝	jiao'liao'yi'zhi	1
蛟龙得水	jiao'long'de'shui	1
教猱升木	jiao'nao'sheng'mu	1
交浅言深	jiao'qian'yan'shen	1
矫情镇物	jiao'qing'zhen'wu	1
矫揉造作	jiao'rou'zao'zuo	1
皎如日星	jiao'ru'ri'xing	1
矫若惊龙	jiao'ruo'jing'long	1
骄奢淫逸	jiao'she'yin'yi	1
娇生惯养	jiao'sheng'guan'yang	1
矫时慢物	jiao'shi'man'wu	1
脚踏实地	jiao'ta'shi'di	1
交头接耳	jiao'tou'jie'er	1
焦头烂额	jiao'tou'lan'e	1
狡兔三窟	jiao'tu'san'ku	1
矫枉过正	jiao'wang'guo'zheng	1
教无常师	jiao'wu'chang'shi	1
较武论文	jiao'wu'lun'wen	1
交相辉映	jiao'xiang'hui'ying	1
娇小玲珑	jiao'xiao'ling'long	1
矫邪归正	jiao'xie'gui'zheng	1
焦心热中	jiao'xin're'zhong	1
教学相长	jiao'xue'xiang'zhang	1
皎阳似火	jiao'yang'shi'huo	1
教亦多术	jiao'yi'duo'shu	1
教一识百	jiao'yi'shi'bai	1
胶柱鼓瑟	jiao'zhu'gu'se	1
胶柱调瑟	jiao'zhu'tiao'se	1
节哀顺变	jie'ai'shun'bian	1
桀骜不驯	jie'ao'bu'xun	1
捷报频传	jie'bao'pin'chuan	1
戒备森严	jie'bei'sen'yan	1
解兵释甲	jie'bing'shi'jia	1
结不解缘	jie'bu'jie'yuan	1
结草衔环	jie'cao'xian'huan	1
藉草枕块	jie'cao'zhen'kuai	1
截长补短	jie'chang'bu'duan	1
竭诚相待	jie'cheng'xiang'dai	1
皆大欢喜	jie'da'huan'xi	1
借贷无门	jie'dai'wu'men	1
结党营私	jie'dang'ying'si	1
借刀杀人	jie'dao'sha'ren	1
接二连三	jie'er'lian'san	1
结发夫妻	jie'fa'fu'qi	1
解发佯狂	jie'fa'yang'kuang	1
借风使船	jie'feng'shi'chuan	1
接风洗尘	jie'feng'xi'chen	1
劫富济贫	jie'fu'ji'pin	1
揭竿而起	jie'gan'er'qi	1
羯鼓催花	jie'gu'cui'hua	1
借古讽今	jie'gu'feng'jin	1
借古喻今	jie'gu'yu'jin	1
截鹤续凫	jie'he'xu'fu	1
劫后余生	jie'hou'yu'sheng	1
借花献佛	jie'hua'xian'fo	1
嗟悔无及	jie'hui'wu'ji	1
洁己奉公	jie'ji'feng'gong	1
解甲归田	jie'jia'gui'tian	1
解甲投戈	jie'jia'tou'ge	1
借交报仇	jie'jiao'bao'chou	1
戒骄戒躁	jie'jiao'jie'zao	1
结结巴巴	jie'jie'ba'ba	1
竭尽全力	jie'jin'quan'li	1
借酒浇愁	jie'jiu'jiao'chou	1
嗟来之食	jie'lai'zhi'shi	1
竭力虔心	jie'li'qian'xin	1
接连不断	jie'lian'bu'duan	1
解铃系铃	jie'ling'ji'ling	1
借面吊丧	jie'mian'diao'sang	1
解民倒悬	jie'min'dao'xuan	1
解囊相助	jie'nang'xiang'zhu	1
阶前万里	jie'qian'wan'li	1
诘屈聱牙	jie'qu'ao'ya	1
桀犬吠尧	jie'quan'fei'yao	1
截然不同	jie'ran'bu'tong	1
孑然一身	jie'ran'yi'shen	1
解人难得	jie'ren'nan'de	1
诘戎治兵	jie'rong'zhi'bing	1
接三连四	jie'san'lian'si	1
戒奢宁俭	jie'she'ning'jian	1
洁身自好	jie'shen'zi'hao	1
结绳而治	jie'sheng'er'zhi	1
借尸还魂	jie'shi'huan'hun	1
借书留真	jie'shu'liu'zhen	1
劫数难逃	jie'shu'nan'tao	1
结驷连骑	jie'si'lian'qi	1
街谈巷议	jie'tan'xiang'yi	1
借题发挥	jie'ti'fa'hui	1
街头巷尾	jie'tou'xiang'wei	1
节外生枝	jie'wai'sheng'zhi	1
解弦更张	jie'xian'geng'zhang	1
街巷阡陌	jie'xiang'qian'mo	1
解疑释惑	jie'yi'shi'huo	1
节衣缩食	jie'yi'suo'shi	1
解衣推食	jie'yi'tui'shi	1
解衣卸甲	jie'yi'xie'jia	1
节用裕民	jie'yong'yu'min	1
竭泽而渔	jie'ze'er'yu	1
竭泽焚薮	jie'ze'fen'sou	1
竭智尽忠	jie'zhi'jin'zhong	1
截趾适屦	jie'zhi'shi'ju	1
接踵比肩	jie'zhong'bi'jian	1
接踵而来	jie'zhong'er'lai	1
接踵而至	jie'zhong'er'zhi	1
借箸代筹	jie'zhu'dai'chou	1
捷足先得	jie'zu'xian'de	1
捷足先登	jie'zu'xian'deng	1
金榜题名	jin'bang'ti'ming	1
金碧辉煌	jin'bi'hui'huang	1
今不如昔	jin'bu'ru'xi	1
矜才使气	jin'cai'shi'qi	1
金钗换酒	jin'chai'huan'jiu	1
金钗十二	jin'chai'shi'er	1
进谗害贤	jin'chan'hai'xian	1
金蝉脱壳	jin'chan'tuo'qiao	1
金城汤池	jin'cheng'tang'chi	1
金翅擘海	jin'chi'bai'hai	1
今愁古恨	jin'chou'gu'hen	1
进寸退尺	jin'cun'tui'chi	1
紧打慢敲	jin'da'man'qiao	1
金貂换酒	jin'diao'huan'jiu	1
今非昔比	jin'fei'xi'bi	1
金风送爽	jin'feng'song'shuang	1
金风玉露	jin'feng'yu'lu	1
金刚怒目	jin'gang'nu'mu	1
金戈铁马	jin'ge'tie'ma	1
矜功自伐	jin'gong'zi'fa	1
金谷酒数	jin'gu'jiu'shu	1
金鼓齐鸣	jin'gu'qi'ming	1
津关险塞	jin'guan'xian'sai	1
金龟换酒	jin'gui'huan'jiu	1
金匮石室	jin'gui'shi'shi	1
巾帼奇才	jin'guo'qi'cai	1
巾帼须眉	jin'guo'xu'mei	1
巾帼英雄	jin'guo'ying'xiong	1
巾帼丈夫	jin'guo'zhang'fu	1
金壶墨汁	jin'hu'mo'zhi	1
襟怀磊落	jin'huai'lei'luo	1
襟怀洒落	jin'huai'sa'luo	1
襟怀坦白	jin'huai'tan'bai	1
尽欢而散	jin'huan'er'san	1
近火先焦	jin'huo'xian'jiao	1
金鸡独立	jin'ji'du'li	1
金鸡消息	jin'ji'xiao'xi	1
金枷玉锁	jin'jia'yu'suo	1
襟江带湖	jin'jiang'dai'hu	1
金浆玉醴	jin'jiang'yu'li	1
斤斤计较	jin'jin'ji'jiao	1
津津乐道	jin'jin'le'dao	1
金尽裘弊	jin'jin'qiu'bi	1
津津有味	jin'jin'you'wei	1
斤斤自守	jin'jin'zi'shou	1
金精玉液	jin'jing'yu'ye	1
金科玉律	jin'ke'yu'lv	1
金科玉条	jin'ke'yu'tiao	1
金口木舌	jin'kou'mu'she	1
金口玉言	jin'kou'yu'yan	1
金兰之契	jin'lan'zhi'qi	1
金兰之友	jin'lan'zhi'you	1
尽力而为	jin'li'er'wei	1
紧锣密鼓	jin'luo'mi'gu	1
进旅退旅	jin'lv'tui'lv	1
金马玉堂	jin'ma'yu'tang	1
谨毛失貌	jin'mao'shi'mao	1
金迷纸醉	jin'mi'zhi'zui	1
锦囊佳句	jin'nang'jia'ju	1
锦囊妙计	jin'nang'miao'ji	1
金瓯无缺	jin'ou'wu'que	1
筋疲力竭	jin'pi'li'jie	1
筋疲力尽	jin'pi'li'jin	1
金瓶落井	jin'ping'luo'jing	1
尽其所长	jin'qi'suo'chang	1
尽人皆知	jin'ren'jie'zhi	1
金人之缄	jin'ren'zhi'jian	1
仅容旋马	jin'rong'xuan'ma	1
尽入彀中	jin'ru'gou'zhong	1
尽如人意	jin'ru'ren'yi	1
进锐退速	jin'rui'tui'su	1
浸润之谮	jin'run'zhi'zen	1
噤若寒蝉	jin'ruo'han'chan	1
锦瑟年华	jin'se'nian'hua	1
尽善尽美	jin'shan'jin'mei	1
锦上添花	jin'shang'tian'hua	1
金舌弊口	jin'she'bi'kou	1
进身之阶	jin'shen'zhi'jie	1
金声玉润	jin'sheng'yu'run	1
金声玉振	jin'sheng'yu'zhen	1
金石丝竹	jin'shi'si'zhu	1
金石为开	jin'shi'wei'kai	1
金石之策	jin'shi'zhi'ce	1
金石之计	jin'shi'zhi'ji	1
金石之坚	jin'shi'zhi'jian	1
金石之交	jin'shi'zhi'jiao	1
今是昨非	jin'shi'zuo'fei	1
近水楼台	jin'shui'lou'tai	1
尽态极妍	jin'tai'ji'yan	1
金汤之固	jin'tang'zhi'gu	1
金题玉躞	jin'ti'yu'xie	1
锦天绣地	jin'tian'xiu'di	1
金童玉女	jin'tong'yu'nv	1
进退存亡	jin'tui'cun'wang	1
进退两难	jin'tui'liang'nan	1
进退失据	jin'tui'shi'ju	1
进退维谷	jin'tui'wei'gu	1
进退无门	jin'tui'wu'men	1
进退有常	jin'tui'you'chang	1
金吾不禁	jin'wu'bu'jin	1
金屋藏娇	jin'wu'cang'jiao	1
近乡情怯	jin'xiang'qing'qie	1
金相玉质	jin'xiang'yu'zhi	1
谨小慎微	jin'xiao'shen'wei	1
尽心竭力	jin'xin'jie'li	1
锦心绣肠	jin'xin'xiu'chang	1
锦心绣口	jin'xin'xiu'kou	1
锦绣肝肠	jin'xiu'gan'chang	1
锦绣河山	jin'xiu'he'shan	1
锦绣前程	jin'xiu'qian'cheng	1
锦绣山河	jin'xiu'shan'he	1
谨言慎行	jin'yan'shen'xing	1
仅以身免	jin'yi'shen'mian	1
锦衣行昼	jin'yi'xing'zhou	1
锦衣玉食	jin'yi'yu'shi	1
金印紫绶	jin'yin'zi'shou	1
金友玉昆	jin'you'yu'kun	1
金玉锦绣	jin'yu'jin'xiu	1
金玉良言	jin'yu'liang'yan	1
金玉良缘	jin'yu'liang'yuan	1
金玉满堂	jin'yu'man'tang	1
金玉其质	jin'yu'qi'zhi	1
矜愚饰智	jin'yu'shi'zhi	1
今月古月	jin'yue'gu'yue	1
近悦远来	jin'yue'yuan'lai	1
近在眉睫	jin'zai'mei'jie	1
近在咫尺	jin'zai'zhi'chi	1
金针度人	jin'zhen'du'ren	1
金枝玉叶	jin'zhi'yu'ye	1
尽忠报国	jin'zhong'bao'guo	1
金字招牌	jin'zi'zhao'pai	1
经帮纬国	jing'bang'wei'guo	1
精兵简政	jing'bing'jian'zheng	1
精兵强将	jing'bing'qiang'jiang	1
精采秀发	jing'cai'xiu'fa	1
荆钗布裙	jing'chai'bu'qun	1
敬陈管见	jing'chen'guan'jian	1
精诚团结	jing'cheng'tuan'jie	1
精打细算	jing'da'xi'suan	1
井底之蛙	jing'di'zhi'wa	1
精雕细刻	jing'diao'xi'ke	1
惊愕失色	jing'e'shi'se	1
敬而远之	jing'er'yuan'zhi	1
精耕细作	jing'geng'xi'zuo	1
敬恭桑梓	jing'gong'sang'zi	1
惊弓之鸟	jing'gong'zhi'niao	1
精贯白日	jing'guan'bai'ri	1
静观默察	jing'guan'mo'cha	1
经国大业	jing'guo'da'ye	1
经国之才	jing'guo'zhi'cai	1
惊鸿艳影	jing'hong'yan'ying	1
镜花水月	jing'hua'shui'yue	1
惊惶失措	jing'huang'shi'cuo	1
惊慌失措	jing'huang'shi'cuo	1
惊魂未定	jing'hun'wei'ding	1
荆棘丛生	jing'ji'cong'sheng	1
荆棘塞途	jing'ji'se'tu	1
静极思动	jing'ji'si'dong	1
荆棘铜驼	jing'ji'tong'tuo	1
荆棘载途	jing'ji'zai'tu	1
精金百炼	jing'jin'bai'lian	1
精金良玉	jing'jin'liang'yu	1
兢兢业业	jing'jing'ye'ye	1
井井有条	jing'jing'you'tiao	1
经久不息	jing'jiu'bu'xi	1
井臼亲操	jing'jiu'qin'cao	1
惊恐失色	jing'kong'shi'se	1
惊恐万状	jing'kong'wan'zhuang	1
敬老慈幼	jing'lao'ci'you	1
敬老尊贤	jing'lao'zun'xian	1
精力充沛	jing'li'chong'pei	1
镜里观花	jing'li'guan'hua	1
精妙绝伦	jing'miao'jue'lun	1
精明强干	jing'ming'qiang'gan	1
经明行修	jing'ming'xing'xiu	1
经年累月	jing'nian'lei'yue	1
精疲力尽	jing'pi'li'jin	1
镜破钗分	jing'po'chai'fen	1
旌旗蔽日	jing'qi'bi'ri	1
旌旗卷舒	jing'qi'juan'shu	1
径情直遂	jing'qing'zhi'sui	1
径情直行	jing'qing'zhi'xing	1
经丘寻壑	jing'qiu'xun'he	1
井然有序	jing'ran'you'xu	1
荆人涉澭	jing'ren'she'yong	1
敬如上宾	jing'ru'shang'bin	1
精锐之师	jing'rui'zhi'shi	1
敬若神明	jing'ruo'shen'ming	1
荆山之玉	jing'shan'zhi'yu	1
惊蛇入草	jing'she'ru'cao	1
精神抖擞	jing'shen'dou'sou	1
精神焕发	jing'shen'huan'fa	1
精神恍忽	jing'shen'huang'hu	1
精神满腹	jing'shen'man'fu	1
经史百子	jing'shi'bai'zi	1
惊师动众	jing'shi'dong'zhong	1
惊世骇俗	jing'shi'hai'su	1
惊涛骇浪	jing'tao'hai'lang	1
惊天动地	jing'tian'dong'di	1
荆天棘地	jing'tian'ji'di	1
经天纬地	jing'tian'wei'di	1
井蛙之见	jing'wa'zhi'jian	1
泾渭不分	jing'wei'bu'fen	1
泾渭分明	jing'wei'fen'ming	1
精卫填海	jing'wei'tian'hai	1
经纬天下	jing'wei'tian'xia	1
经纬万端	jing'wei'wan'duan	1
经文纬武	jing'wen'wei'wu	1
鲸吸牛饮	jing'xi'niu'yin	1
惊喜欲狂	jing'xi'ruo'kuang	1
惊喜若狂	jing'xi'ruo'kuang	1
敬贤礼士	jing'xian'li'shi	1
敬小慎微	jing'xiao'shen'wei	1
敬谢不敏	jing'xie'bu'min	1
惊心悼胆	jing'xin'dao'dan	1
惊心动魄	jing'xing'dong'po	1
敬业乐群	jing'ye'yao'qun	1
精益求精	jing'yi'qiu'jing	1
惊猿脱兔	jing'yuan'tuo'tu	1
荆榛满目	jing'zhen'man'mu	1
敬终慎始	jing'zhong'shen'shi	1
井中视星	jing'zhong'shi'xing	1
泾浊渭清	jing'zhuo'wei'qing	1
炯炯有神	jiong'jiong'you'shen	1
迥然不群	jiong'ran'bu'qun	1
迥然不同	jiong'ran'bu'tong	1
久安长治	jiu'an'chang'zhi	1
久别重逢	jiu'bie'chong'feng	1
久病成医	jiu'bing'cheng'yi	1
纠缠不清	jiu'chan'bu'qing	1
酒池肉林	jiu'chi'rou'lin	1
旧仇宿怨	jiu'chou'su'yuan	1
旧愁新恨	jiu'chou'xin'hen	1
臼杵之交	jiu'chu'zhi'jiao	1
旧地重游	jiu'di'chong'you	1
就地取材	jiu'di'qu'cai	1
就地正法	jiu'di'zheng'fa	1
旧调重弹	jiu'diao'chong'tan	1
九鼎大吕	jiu'ding'da'lv	1
久而久之	jiu'er'jiu'zhi	1
久负盛名	jiu'fu'sheng'ming	1
九垓八埏	jiu'gai'ba'yan	1
久惯牢成	jiu'guan'lao'cheng	1
救过补阙	jiu'guo'bu'que	1
酒酣耳热	jiu'han'er're	1
纠合之众	jiu'he'zhi'zhong	1
旧恨新仇	jiu'hen'xin'chou	1
酒后失言	jiu'hou'shi'yan	1
酒后无德	jiu'hou'wu'de	1
久怀慕蔺	jiu'huai'mu'lin	1
九回肠断	jiu'hui'chang'duan	1
救火投薪	jiu'huo'tou'xin	1
救火扬沸	jiu'huo'yang'fei	1
鸠集凤池	jiu'ji'feng'chi	1
久假不归	jiu'jia'bu'gui	1
久经风霜	jiu'jing'feng'shuang	1
救经引足	jiu'jing'yin'zu	1
九九归一	jiu'jiu'gui'yi	1
赳赳武夫	jiu'jiu'wu'fu	1
久居人下	jiu'ju'ren'xia	1
救苦救难	jiu'ku'jiu'nan	1
救困扶危	jiu'kun'fu'wei	1
酒阑人散	jiu'lan'ren'san	1
九烈三贞	jiu'lie'san'zhen	1
九流人物	jiu'liu'ren'wu	1
九流三教	jiu'liu'san'jiao	1
九流十家	jiu'liu'shi'jia	1
酒绿灯红	jiu'lv'deng'hong	1
酒囊饭袋	jiu'nang'fan'dai	1
旧念复萌	jiu'nian'fu'mang	1
九年之蓄	jiu'nian'zhi'xu	1
九牛一毛	jiu'niu'yi'mao	1
九曲回肠	jiu'qu'hui'chang	1
九泉之下	jiu'quan'zhi'xia	1
酒肉朋友	jiu'rou'peng'you	1
酒入舌出	jiu'ru'she'chu	1
九儒十丐	jiu'ru'shi'gai	1
酒色财气	jiu'se'cai'qi	1
酒色之徒	jiu'se'zhi'tu	1
酒食地狱	jiu'shi'di'yu	1
救世济民	jiu'shi'ji'min	1
就事论事	jiu'shi'lun'shi	1
酒食征逐	jiu'shi'zheng'zhu	1
九世之仇	jiu'shi'zhi'chou	1
救死扶伤	jiu'si'fu'shang	1
九死未悔	jiu'si'wei'hui	1
九死一生	jiu'si'yi'sheng	1
酒酸不售	jiu'suan'bu'shou	1
就汤下面	jiu'tang'xia'mian	1
九天九地	jiu'tian'jiu'di	1
九天揽月	jiu'tian'lan'yue	1
臼头深目	jiu'tou'shen'mu	1
救亡图存	jiu'wang'tu'cun	1
久闻大名	jiu'wen'da'ming	1
九五之尊	jiu'wu'zhi'zun	1
九霄云外	jiu'xiao'yun'wai	1
疚心疾首	jiu'xin'ji'shou	1
鸠形鹄面	jiu'xing'hu'mian	1
久悬不决	jiu'xuan'bu'jue	1
久要不忘	jiu'yao'bu'wang	1
酒有别肠	jiu'you'bie'chang	1
咎有应得	jiu'you'ying'de	1
咎由自取	jiu'you'zi'qu	1
旧雨重逢	jiu'yu'chong'feng	1
旧雨今雨	jiu'yu'jin'yu	1
九原可作	jiu'yuan'ke'zuo	1
臼灶生蛙	jiu'zao'sheng'wa	1
鸠占鹊巢	jiu'zhan'que'chao	1
就正有道	jiu'zheng'you'dao	1
九洲四海	jiu'zhou'si'hai	1
九转功成	jiu'zhuan'gong'cheng	1
酒足饭饱	jiu'zu'fan'bao	1
酒醉饭饱	jiu'zui'fan'bao	1
据鞍读书	ju'an'du'shu	1
举案齐眉	ju'an'qi'mei	1
居安思危	ju'an'si'wei	1
居安资深	ju'an'zi'shen	1
居不重席	ju'bu'chong'xi	1
矩步方行	ju'bu'fang'xing	1
举步生风	ju'bu'sheng'feng	1
举不胜举	ju'bu'sheng'ju	1
驹齿未落	ju'chi'wei'luo	1
局促不安	ju'cu'bu'an	1
举措不当	ju'cuo'bu'dang	1
居大不易	ju'da'bu'yi	1
举鼎拔山	ju'ding'ba'shan	1
举鼎绝膑	ju'ding'jue'bin	1
居高临下	ju'gao'lin'xia	1
居功自傲	ju'gong'zi'ao	1
居官守法	ju'guan'shou'fa	1
举国若狂	ju'guo'ruo'kuang	1
举国上下	ju'guo'shang'xia	1
举国一致	ju'guo'yi'zhi	1
橘化为枳	ju'hua'wei'zhi	1
屦及剑及	ju'ji'jian'ji	1
拒谏饰非	ju'jian'shi'fei	1
屦贱踊贵	ju'jian'yong'gui	1
聚精会神	ju'jing'hui'shen	1
踽踽独行	ju'ju'du'xing	1
咀嚼英华	ju'jue'ying'hua	1
举例发凡	ju'li'fa'fan	1
据理力争	ju'li'li'zheng	1
聚敛无厌	ju'lian'wu'yan	1
踞炉炭上	ju'lu'tan'shang	1
聚米为山	ju'mi'wei'shan	1
举目千里	ju'mu'qian'li	1
举目无亲	ju'mu'wu'qin	1
局骗拐带	ju'pian'guai'dai	1
举棋不定	ju'qi'bu'ding	1
聚沙成塔	ju'sha'cheng'ta	1
举善荐贤	ju'shan'jian'xian	1
聚少成多	ju'shao'cheng'duo	1
拘神遣将	ju'shen'qian'jiang	1
举世混浊	ju'shi'hun'zhuo	1
举世闻名	ju'shi'wen'ming	1
举世无敌	ju'shi'wu'di	1
举世无双	ju'shi'wu'shuang	1
举十知九	ju'shi'zhi'jiu	1
举世瞩目	ju'shi'zhu'mu	1
俱收并蓄	ju'shou'bing'xu	1
举手加额	ju'shou'jia'e	1
举手投足	ju'shou'tou'zu	1
举手之劳	ju'shou'zhi'lao	1
聚讼纷纭	ju'song'fen'yun	1
具体而微	ju'ti'er'wei	1
跼天蹐地	ju'tian'ji'di	1
居停主人	ju'ting'zhu'ren	1
局外之人	ju'wai'zhi'ren	1
举枉措直	ju'wang'cuo'zhi	1
据为己有	ju'wei'ji'you	1
聚蚊成雷	ju'wen'cheng'lei	1
举无遗策	ju'wu'yi'ce	1
举贤使能	ju'xian'shi'neng	1
居心不良	ju'xin'bu'liang	1
居心叵测	ju'xin'po'ce	1
居心险恶	ju'xin'xian'e	1
钜学鸿生	ju'xue'hong'sheng	1
举要删芜	ju'yao'shan'wu	1
举一反三	ju'yi'fan'san	1
举一废百	ju'yi'fei'bai	1
龃龉不合	ju'yu'bu'he	1
句斟字酌	ju'zhen'zi'zhuo	1
居之不疑	ju'zhi'bu'yi	1
举直措枉	ju'zhi'cuo'wang	1
拒之门外	ju'zhi'men'wai	1
举止失措	ju'zhi'shi'cuo	1
举止娴雅	ju'zhi'xian'ya	1
举止言谈	ju'zhi'yan'tan	1
举重若轻	ju'zhong'ruo'qing	1
举足轻重	ju'zu'qing'zhong	1
涓埃之力	juan'ai'zhi'li	1
涓滴成河	juan'di'cheng'he	1
涓滴归公	juan'di'gui'gong	1
娟好静秀	juan'hao'jing'xiu	1
狷介之士	juan'jie'zhi'shi	1
眷眷之心	juan'juan'zhi'xin	1
圈牢养物	juan'lao'yang'wu	1
倦鸟知还	juan'niao'zhi'huan	1
捐弃前嫌	juan'qi'qian'xian	1
捐躯赴难	juan'qu'fu'nan	1
捐躯殉国	juan'qu'xun'guo	1
卷土重来	juan'tu'chong'lai	1
镌心铭骨	juan'xin'ming'gu	1
卷帙浩繁	juan'zhi'hao'fan	1
绝长补短	jue'chang'bu'duan	1
绝处逢生	jue'chu'feng'sheng	1
绝代佳人	jue'dai'jia'ren	1
崛地而起	jue'di'er'qi	1
绝顶聪明	jue'ding'cong'ming	1
决断如流	jue'duan'ru'liu	1
谲而不正	jue'er'bu'zheng	1
绝甘分少	jue'gan'fen'shao	1
谲怪之谈	jue'guai'zhi'tan	1
倔强倨傲	jue'jiang'ju'ao	1
掘井及泉	jue'jing'ji'quan	1
绝裾而去	jue'ju'er'qu	1
绝口不道	jue'kou'bu'dao	1
绝路逢生	jue'lu'feng'sheng	1
绝妙好辞	jue'miao'hao'ci	1
嚼墨喷纸	jue'mo'pen'zhi	1
绝其本根	jue'qi'ben'gen	1
绝仁弃义	jue'ren'qi'yi	1
绝少分甘	jue'shao'fen'gan	1
决胜庙堂	jue'sheng'miao'tang	1
绝圣弃智	jue'sheng'qi'zhi	1
决胜千里	jue'sheng'qian'li	1
绝世超伦	jue'shi'chao'lun	1
绝世独立	jue'shi'du'li	1
掘室求鼠	jue'shi'qiu'shu	1
绝世无双	jue'shi'wu'shuang	1
攫为己有	jue'wei'ji'you	1
绝无仅有	jue'wu'jin'you	1
抉瑕掩瑜	jue'xia'yan'yu	1
绝薪止火	jue'xin'zhi'huo	1
决一雌雄	jue'yi'ci'xiong	1
决一胜负	jue'yi'sheng'fu	1
决一死战	jue'yi'si'zhan	1
俊杰廉悍	jun'jie'lian'han	1
军令如山	jun'ling'ru'shan	1
君命无二	jun'ming'wu'er	1
君辱臣死	jun'ru'chen'si	1
钧天广乐	jun'tian'guang'yue	1
君子固穷	jun'zi'gu'qiong	1
君子之交	jun'zi'zhi'jiao	1
开诚布公	kai'cheng'bu'gong	1
开诚相见	kai'cheng'xiang'jian	1
慨当以慷	kai'dang'yi'kang	1
开国功臣	kai'guo'gong'chen	1
开国元老	kai'guo'yuan'lao	1
开国元勋	kai'guo'yuan'xun	1
开花结果	kai'hua'jie'guo	1
开怀畅饮	kai'huan'chang'yin	1
开基立业	kai'ji'li'ye	1
开卷有益	kai'juan'you'yi	1
开科取士	kai'ke'qu'shi	1
开路先锋	kai'lu'xian'feng	1
开门见山	kai'men'jian'shan	1
开门揖盗	kai'men'yi'dao	1
慨然允诺	kai'ran'yun'nuo	1
开山祖师	kai'shan'zu'shi	1
开台锣鼓	kai'tai'luo'gu	1
开天辟地	kai'tian'pi'di	1
开物成务	kai'wu'cheng'wu	1
开雾睹天	kai'wu'du'tian	1
开柙出虎	kai'xia'chu'hu	1
开心见诚	kai'xin'jian'cheng	1
开源节流	kai'yuan'jie'liu	1
开云见日	kai'yun'jian'ri	1
开宗明义	kai'zong'ming'yi	1
看菜吃饭	kan'cai'chi'fan	1
看风使舵	kan'feng'shi'duo	1
坎井之蛙	kan'jing'zhi'wa	1
侃侃而谈	kan'kan'er'tan	1
看破红尘	kan'po'hong'chen	1
看人眉眼	kan'ren'mei'yan	1
看杀卫玠	kan'sha'wei'jie	1
堪以告慰	kan'yi'gao'wei	1
看朱成碧	kan'zhu'cheng'bi	1
抗尘走俗	kang'chen'zou'su	1
扛鼎抃牛	kang'ding'bian'niu	1
慷慨悲歌	kang'kai'bei'ge	1
慷慨陈词	kang'kai'chen'ci	1
慷慨赴义	kang'kai'fu'yi	1
慷慨激昂	kang'kai'ji'ang	1
慷慨激扬	kang'kai'ji'yang	1
慷慨解囊	kang'kai'jie'nang	1
慷慨输将	kang'kai'shu'jiang	1
伉俪情深	kang'li'qing'shen	1
抗颜为师	kang'yan'wei'shi	1
康庄大道	kang'zhuang'da'dao	1
考绩幽明	kao'ji'you'ming	1
犒赏三军	kao'shang'san'jun	1
科班出身	ke'ban'chu'shen	1
刻不容缓	ke'bu'rong'huan	1
可操左券	ke'cao'zuo'quan	1
渴尘万斛	ke'chen'wan'hu	1
可乘之机	ke'cheng'zhi'ji	1
可乘之隙	ke'cheng'zhi'xi	1
克敌制胜	ke'di'zhi'sheng	1
渴而掘井	ke'er'jue'jing	1
可发一噱	ke'fa'yi'jue	1
可歌可泣	ke'ge'ke'qi	1
刻骨仇恨	ke'gu'chou'hen	1
刻骨镂心	ke'gu'lou'xin	1
刻骨铭心	ke'gu'ming'xin	1
刻骨相思	ke'gu'xiang'si	1
刻鹄类鹜	ke'hu'lei'wu	1
刻画入微	ke'hua'ru'wei	1
刻画无盐	ke'hua'wu'yan	1
渴骥奔泉	ke'ji'ben'quan	1
克己奉公	ke'ji'feng'gong	1
克己复礼	ke'ji'fu'li	1
刻肌刻骨	ke'ji'ke'gu	1
克己慎行	ke'ji'shen'xing	1
克尽厥职	ke'jin'jue'zhi	1
苛捐杂税	ke'juan'za'shui	1
刻苦耐劳	ke'ku'nai'lao	1
刻木为吏	ke'mu'wei'li	1
克勤克俭	ke'qin'ke'jian	1
溘然长往	ke'ran'chang'wang	1
克绍箕裘	ke'shao'ji'qiu	1
恪守不渝	ke'shou'bu'yu	1
恪守成宪	ke'shou'cheng'xian	1
客死他乡	ke'si'ta'xiang	1
磕头礼拜	ke'tou'li'bai	1
磕头碰脑	ke'tou'peng'nao	1
磕头如捣	ke'tou'ru'dao	1
科头跣足	ke'tou'xian'zu	1
可想而知	ke'xiang'er'zhi	1
可心如意	ke'xin'ru'yi	1
刻意经营	ke'yi'jing'ying	1
可有可无	ke'you'ke'wu	1
渴者易饮	ke'zhe'yi'yin	1
刻舟求剑	ke'zhou'qiu'jian	1
刻足适屦	ke'zu'shi'ju	1
肯堂肯构	ken'tang'ken'gou	1
硁硁之愚	keng'keng'zhi'yu	1
铿镪顿挫	keng'qiang'dun'cuo	1
空洞无物	kong'dong'wu'wu	1
空费词说	kong'fei'ci'shuo	1
空谷白驹	kong'gu'bai'ju	1
空谷传声	kong'gu'chuan'sheng	1
空谷幽兰	kong'gu'you'lan	1
空谷足音	kong'gu'zu'yin	1
空话连篇	kong'hua'lian'pian	1
恐慌万状	kong'huang'wan'zhuang	1
空空如也	kong'kong'ru'ye	1
空口无凭	kong'kou'wu'ping	1
孔孟之道	kong'meng'zhi'dao	1
控名责实	kong'ming'ze'shi	1
空前绝后	kong'qian'jue'hou	1
空室清野	kong'shi'qing'ye	1
空头支票	kong'tou'zhi'piao	1
孔武有力	kong'wu'you'li	1
孔席墨突	kong'xi'mo'tu	1
空穴来风	kong'xue'lai'feng	1
恐遭物议	kong'zao'wu'yi	1
空中楼阁	kong'zhong'lou'ge	1
口碑载道	kou'bei'zai'dao	1
口不应心	kou'bu'ying'xin	1
口齿伶俐	kou'chi'ling'li	1
口齿生香	kou'chi'sheng'xiang	1
口出不逊	kou'chu'bu'xun	1
口出大言	kou'chu'da'yan	1
口多食寡	kou'duo'shi'gua	1
口耳并重	kou'er'bing'zhong	1
口耳之学	kou'er'zhi'xue	1
口沸目赤	kou'fei'mu'chi	1
口腹之累	kou'fu'zhi'lei	1
口含天宪	kou'han'tian'xian	1
口讲指画	kou'jiang'zhi'hua	1
口角春风	kou'jiao'chun'feng	1
口口声声	kou'kou'sheng'sheng	1
口口相传	kou'kou'xiang'chuan	1
叩马而谏	kou'ma'er'jian	1
口蜜腹剑	kou'mi'fu'jian	1
扣槃扪烛	kou'pan'men'zhu	1
扣人心弦	kou'ren'xin'xian	1
口若悬河	kou'ruo'xuan'he	1
口尚乳臭	kou'shang'ru'xiu	1
叩石垦壤	kou'shi'ken'rang	1
口是心非	kou'shi'xin'fei	1
口说无凭	kou'shuo'wu'ping	1
口诵心惟	kou'song'xin'wei	1
口吐珠玑	kou'tu'zhu'ji	1
口吻生花	kou'wen'sheng'hua	1
抠心挖肚	kou'xin'wa'du	1
口血未干	kou'xue'wei'gan	1
口燥唇干	kou'zao'chun'gan	1
口中雌黄	kou'zhong'ci'huang	1
口中蚤虱	kou'zhong'zao'shi	1
口诛笔伐	kou'zhu'bi'fa	1
苦不堪言	ku'bu'kan'yan	1
苦大仇深	ku'da'chou'shen	1
苦海无边	ku'hai'wu'bian	1
苦尽甘来	ku'jin'gan'lai	1
苦尽甜来	ku'jin'tian'lai	1
苦口良药	ku'kou'liang'yao	1
苦口逆耳	ku'kou'ni'er	1
苦口婆心	ku'kou'po'xin	1
苦乐不均	ku'le'bu'jun	1
枯苗望雨	ku'miao'wang'yu	1
枯木逢春	ku'mu'feng'chun	1
枯木死灰	ku'mu'si'hui	1
枯木朽株	ku'mu'xiu'zhu	1
枯木再生	ku'mu'zai'sheng	1
苦难深重	ku'nan'shen'zhong	1
哭丧着脸	ku'sang'zhe'lian	1
枯树生花	ku'shu'sheng'hua	1
苦思冥想	ku'si'ming'xiang	1
哭天喊地	ku'tian'han'di	1
哭天抹泪	ku'tian'mo'lei	1
哭笑不得	ku'xiao'bu'de	1
苦心孤诣	ku'xin'gu'yi	1
苦心积虑	ku'xin'ji'lv	1
苦心经营	ku'xin'jing'ying	1
枯形灰心	ku'xing'hui'xin	1
枯杨生稊	ku'yang'sheng'ti	1
枯鱼衔索	ku'yu'xian'suo	1
枯鱼之肆	ku'yu'zhi'si	1
枯燥无味	ku'zao'wu'wei	1
枯枝败叶	ku'zhi'bai'ye	1
苦中作乐	ku'zhong'zuo'le	1
夸大其词	kua'da'qi'ci	1
夸多斗靡	kua'duo'dou'mi	1
跨凤乘鸾	kua'feng'cheng'luan	1
夸父逐日	kua'fu'zhui'ri	1
夸夸其谈	kua'kua'qi'tan	1
姱容修态	kua'rong'xiu'tai	1
胯下之辱	kua'xia'zhi'ru	1
快步流星	kuai'bu'liu'xing	1
快犊破车	kuai'du'po'che	1
快马加鞭	kuai'ma'jia'bian	1
快人快语	kuai'ren'kuai'yu	1
快意当前	kuai'yi'dang'qian	1
脍炙人口	kuai'zhi'ren'kou	1
宽大为怀	kuan'da'wei'huai	1
宽打窄用	kuan'da'zhai'yong	1
宽宏大量	kuan'hong'da'liang	1
款款而谈	kuan'kuan'er'tan	1
宽猛相济	kuan'meng'xiang'ji	1
宽仁大度	kuan'ren'da'du	1
款学寡闻	kuan'xue'gua'wen	1
宽以待人	kuan'yi'dai'ren	1
旷达不羁	kuang'da'bu'ji	1
狂吠狴犴	kuang'fei'bi'an	1
狂风暴雨	kuang'feng'bao'yu	1
狂风骤雨	kuang'feng'zhou'yu	1
旷夫怨女	kuang'fu'yuan'nv	1
旷古绝伦	kuang'gu'jue'lun	1
旷古未闻	kuang'gu'wei'wei	1
旷古未有	kuang'gu'wei'you	1
匡救弥缝	kuang'jiu'mi'feng	1
匡乱反正	kuang'luan'fan'zheng	1
狂奴故态	kuang'nu'gu'tai	1
恇怯不前	kuang'qie'bu'qian	1
筐箧中物	kuang'qie'zhong'wu	1
狂犬吠日	kuang'quan'fei'ri	1
旷日持久	kuang'ri'chi'jiu	1
旷日弥久	kuang'ri'mi'jiu	1
匡时济世	kuang'shi'ji'shi	1
匡时济俗	kuang'shi'ji'su	1
旷世奇才	kuang'shi'qi'cai	1
狂妄自大	kuang'wang'zi'da	1
窥豹一斑	kui'bao'yi'ban	1
溃不成军	kui'bu'cheng'jun	1
跬步千里	kui'bu'qian'li	1
葵藿倾阳	kui'huo'qing'yang	1
窥间伺隙	kui'jian'si'xi	1
揆情度理	kui'qing'duo'li	1
岿然不动	kui'ran'bu'dong	1
喟然长叹	kui'ran'chang'tan	1
岿然独存	kui'ran'du'cun	1
愧天怍人	kui'tian'zuo'ren	1
亏心短行	kui'xin'duan'xing	1
悃愊无华	kun'bi'wu'hua	1
昆弟之好	kun'di'zhi'hao	1
困而不学	kun'er'bu'xue	1
困而学之	kun'er'xue'zhi	1
昆山片玉	kun'shan'pian'yu	1
困兽犹斗	kun'shou'you'dou	1
困心衡虑	kun'xin'heng'lv	1
困知勉行	kun'zhi'mian'xing	1
阔步高谈	kuo'bu'gao'tan	1
廓达大度	kuo'da'da'du	1
拉捭摧藏	la'bai'cui'cang	1
拉家带口	la'jia'dai'kou	1
腊尽春回	la'jin'chun'hui	1
拉三扯四	la'san'che'si	1
拉闲散闷	la'xian'san'men	1
来处不易	lai'chu'bu'yi	1
来回来去	lai'hui'lai'qu	1
来龙去脉	lai'long'qu'mai	1
来情去意	lai'qing'qu'yi	1
来去分明	lai'qu'fen'ming	1
来去无踪	lai'qu'wu'zong	1
来日大难	lai'ri'da'nan	1
来日方长	lai'ri'fang'chang	1
赖有此耳	lai'you'ci'er	1
来者不拒	lai'zhe'bu'ju	1
来者不善	lai'zhe'bu'shan	1
来者可追	lai'zhe'ke'zhui	1
来之不易	lai'zhi'bu'yi	1
来踪去迹	lai'zong'qu'ji	1
兰艾难分	lan'ai'nan'fen	1
兰艾同焚	lan'ai'tong'fen	1
兰摧玉折	lan'cui'yu'zhe	1
兰桂齐芳	lan'gui'qi'fang	1
揽辔澄清	lan'pei'cheng'qing	1
揽辔登车	lan'pei'deng'che	1
揽权纳贿	lan'quan'na'hui	1
烂若披锦	lan'ruo'pi'jin	1
蓝田生玉	lan'tian'sheng'yu	1
兰心蕙性	lan'xin'hui'xing	1
兰薰桂馥	lan'xun'gui'fu	1
兰因絮果	lan'yin'xu'guo	1
滥用职权	lan'yong'zhi'quan	1
滥竽充数	lan'yu'chong'shu	1
兰芝常生	lan'zhi'chang'sheng	1
兰质蕙心	lan'zhi'hui'xin	1
烂醉如泥	lan'zui'ru'ni	1
狼狈不堪	lang'bei'bu'kan	1
狼狈为奸	lang'bei'wei'jian	1
狼奔豕突	lang'ben'shi'tu	1
郎才女貌	lang'cai'nv'mao	1
浪蝶狂蜂	lang'die'kuang'feng	1
浪迹江湖	lang'ji'jiang'hu	1
浪迹萍踪	lang'ji'ping'zong	1
锒铛入狱	lang'kang'ru'yu	1
朗朗乾坤	lang'lang'qian'kun	1
琅琅上口	lang'lang'shang'kou	1
朗目疏眉	lang'mu'shu'mei	1
狼贪虎视	lang'tan'hu'shi	1
狼贪鼠窃	lang'tan'shu'qie	1
狼吞虎咽	lang'tun'hu'yan	1
狼心狗肺	lang'xin'gou'fei	1
狼心狗行	lang'xin'gou'xing	1
狼眼鼠眉	lang'yan'shu'mei	1
狼烟四起	lang'yan'si'qi	1
阆苑琼楼	lang'yuan'qiong'lou	1
浪子回头	lang'zi'hui'tou	1
狼子野心	lang'zi'ye'xin	1
浪子宰相	lang'zi'zai'xiang	1
老蚌生珠	lao'bang'sheng'zhu	1
牢不可破	lao'bu'ke'po	1
老蚕作茧	lao'can'zuo'jian	1
老成持重	lao'cheng'chi'zhong	1
老大无成	lao'da'wu'cheng	1
老当益壮	lao'dang'yi'zhuang	1
老调重谈	lao'diao'chong'tan	1
老而不死	lao'er'bu'si	1
劳而无功	lao'er'wu'gong	1
老骥伏枥	lao'ji'fu'li	1
老奸巨滑	lao'jian'ju'hua	1
劳苦功高	lao'ku'gong'gao	1
老马恋栈	lao'ma'lian'zhan	1
老马识途	lao'ma'shi'tu	1
劳民伤财	lao'min'shang'cai	1
老谋深算	lao'mou'shen'suan	1
老牛破车	lao'niu'po'che	1
老牛舐犊	lao'niu'shi'du	1
老罴当道	lao'pi'dang'dao	1
老气横秋	lao'qi'heng'qiu	1
老弱残兵	lao'ruo'can'bing	1
牢骚满腹	lao'sao'man'fu	1
老僧入定	lao'seng'ru'ding	1
老生常谈	lao'sheng'chang'tan	1
老实巴交	lao'shi'ba'jiao	1
劳师动众	lao'shi'dong'zhong	1
牢什古子	lao'shi'gu'zi	1
劳师袭远	lao'shi'xi'yuan	1
劳思逸淫	lao'si'yi'yin	1
老态龙钟	lao'tai'long'zhong	1
老天拔地	lao'tian'ba'di	1
劳心苦思	lao'xin'ku'si	1
老羞成怒	lao'xiu'cheng'nu	1
老朽无能	lao'xiu'wu'neng	1
劳燕分飞	lao'yan'fen'fei	1
老有所终	lao'you'suo'zhong	1
老妪能解	lao'yu'neng'jie	1
老于世故	lao'yu'shi'gu	1
老之将至	lao'zhi'jiang'zhi	1
乐不可极	le'bu'ke'ji	1
乐不可支	le'bu'ke'zhi	1
乐不思蜀	le'bu'si'shu	1
乐此不疲	le'ci'bu'pi	1
乐道安贫	le'dao'an'pin	1
乐而不淫	le'er'bu'yin	1
乐而忘返	le'er'wang'fan	1
乐极生悲	le'ji'sheng'bei	1
乐善好施	le'shan'hao'shi	1
乐天知命	le'tian'zhi'ming	1
乐业安居	le'ye'an'ju	1
乐以忘忧	le'yi'wang'you	1
乐在其中	le'zai'qi'zhong	1
雷打不动	lei'da'bu'dong	1
累牍连篇	lei'du'lian'pian	1
泪干肠断	lei'gan'chang'duan	1
擂鼓鸣金	lei'gu'ming'jin	1
累教不改	lei'jiao'bu'gai	1
类聚群分	lei'ju'qun'fen	1
累块积苏	lei'kuai'ji'su	1
磊磊落落	lei'lei'luo'luo	1
累累如珠	lei'lei'ru'zhu	1
雷厉风行	lei'li'feng'xing	1
累卵之危	lei'luan'zhi'wei	1
雷鸣瓦釜	lei'ming'wa'fu	1
泪如泉涌	lei'ru'quan'yong	1
泪如雨下	lei'ru'quan'yong	1
雷霆万钧	lei'ting'wan'jun	1
累土至山	lei'tu'zhi'shan	1
累瓦结绳	lei'wa'jie'sheng	1
累屋重架	lei'wu'chong'jia	1
缧绁之忧	lei'xie'zhi'you	1
累月经年	lei'yue'jing'nian	1
冷嘲热讽	leng'chao're'feng	1
冷面寒铁	leng'mian'han'tie	1
冷暖自知	leng'nuan'zi'zhi	1
冷若冰霜	leng'ruo'bing'shuang	1
愣头愣脑	leng'tou'leng'nao	1
冷眼静看	leng'yan'jing'kan	1
冷言冷语	leng'yan'leng'yu	1
冷眼旁观	leng'yan'pang'guan	1
冷眼相待	leng'yan'xiang'dai	1
冷语冰人	leng'yu'bing'ren	1
利傍倚刀	li'bang'yi'dao	1
厉兵秣马	li'bing'mo'ma	1
力不从心	li'bu'cong'xin	1
利不亏义	li'bu'kui'yi	1
力不能支	li'bu'neng'zhi	1
力不胜任	li'bu'sheng'ren	1
嫠不恤纬	li'bu'xu'wei	1
蠡测管窥	li'ce'guan'kui	1
利齿伶牙	li'chi'ling'ya	1
里丑捧心	li'chou'peng'xin	1
里出外进	li'chu'wai'lian	1
利出一孔	li'chu'yi'kong	1
立此存照	li'ci'cun'zhao	1
李代桃僵	li'dai'tao'jiang	1
力殚财竭	li'dan'cai'jie	1
沥胆堕肝	li'dan'duo'gan	1
沥胆披肝	li'dan'pi'gan	1
立地成佛	li'di'cheng'fo	1
力敌千钧	li'di'qian'jun	1
立地书橱	li'di'shu'chu	1
立竿见影	li'gan'jian'ying	1
立功赎罪	li'gong'shu'zui	1
里勾外连	li'gou'wai'lian	1
利害得失	li'hai'de'shi	1
利害相关	li'hai'xiang'guan	1
利害攸关	li'hai'you'guan	1
离合悲欢	li'he'bei'huan	1
梨花带雨	li'hua'dai'yu	1
礼坏乐崩	li'huai'yue'beng	1
力竭声嘶	li'jie'sheng'si	1
力尽筋疲	li'jin'jin'pi	1
离经辨志	li'jing'bian'zhi	1
励精更始	li'jing'geng'shi	1
离经叛道	li'jing'pan'dao	1
励精图治	li'jing'tu'zhi	1
醴酒不设	li'jiu'bu'she	1
力可拔山	li'ke'ba'shan	1
澧兰沅芷	li'lan'yuan'zhi	1
历历可数	li'li'ke'shu	1
栗栗危惧	li'li'wei'ju	1
历历在目	li'li'zai'mu	1
利令智昏	li'ling'zhi'hun	1
离鸾别凤	li'luan'bie'feng	1
立命安身	li'ming'an'shen	1
立木南门	li'mu'nan'men	1
力能扛鼎	li'neng'gang'ding	1
力排众议	li'pai'zhong'yi	1
离情别绪	li'qing'bie'xu	1
黎丘丈人	li'qiu'zhang'ren	1
理屈词穷	li'qu'ci'qiong	1
离群索居	li'qun'suo'ju	1
立人达人	li'ren'da'ren	1
砺山带河	li'shan'dai'he	1
礼尚往来	li'shang'wang'lai	1
立身处世	li'shen'chu'shi	1
利深祸速	li'shen'huo'su	1
立身扬名	li'shen'yang'ming	1
粝食粗衣	li'shi'cu'yi	1
厉世摩钝	li'shi'mo'dun	1
利市三倍	li'shi'san'bei	1
理所当然	li'suo'dang'ran	1
利锁名缰	li'suo'ming'jiang	1
力所能及	li'suo'neng'ji	1
立谈之间	li'tan'zhi'jian	1
离题万里	li'ti'wan'li	1
犁庭扫穴	li'ting'sao'xue	1
里通外国	li'tong'wai'guo	1
力透纸背	li'tou'zhi'bei	1
力挽狂澜	li'wan'kuang'lan	1
利析秋毫	li'xi'qiu'hao	1
礼贤下士	li'xian'xia'shi	1
离弦走板	li'xian'zou'ban	1
离乡背井	li'xiang'bei'jing	1
离心离德	li'xin'li'de	1
例行公事	li'xing'gong'shi	1
厉行节约	li'xing'jie'yue	1
礼义廉耻	li'yi'lian'chi	1
里应外合	li'ying'wai'he	1
利用厚生	li'yong'hou'sheng	1
利欲熏心	li'yu'xun'xin	1
梨园弟子	li'yuan'di'zi	1
丽藻春葩	li'zao'chun'pa	1
力争上游	li'zheng'shang'you	1
励志竭精	li'zhi'jie'jing	1
例直禁简	li'zhi'jin'jian	1
理直气壮	li'zhi'qi'zhuang	1
立锥之地	li'zhui'zhi'di	1
立足之地	li'zu'zhi'di	1
练达老成	lian'da'lao'cheng	1
廉洁奉公	lian'jie'feng'gong	1
廉可寄财	lian'ke'ji'cai	1
连理之木	lian'li'zhi'mu	1
恋恋不舍	lian'lian'bu'she	1
联袂而至	lian'mei'er'zhi	1
连绵不绝	lian'mian'bu'jue	1
廉明公正	lian'ming'gong'zheng	1
联翩而至	lian'pian'er'zhi	1
连篇累牍	lian'pian'lei'du	1
廉泉让水	lian'quan'rang'shui	1
敛容屏气	lian'rong'bing'qi	1
敛声屏气	lian'sheng'bing'qi	1
炼石补天	lian'shi'bu'tian	1
连天烽火	lian'tian'feng'huo	1
怜香惜玉	lian'xiang'xi'yu	1
怜新弃旧	lian'xin'qi'jiu	1
恋新忘旧	lian'xin'wang'jiu	1
廉远堂高	lian'yuan'tang'gao	1
恋栈不去	lian'zhan'bu'qu	1
连枝比翼	lian'zhi'bi'yi	1
连中三元	lian'zhong'san'yuan	1
连珠合璧	lian'zhu'he'bi	1
两败俱伤	liang'bai'ju'shang	1
两部鼓吹	liang'bu'gu'chui	1
量才而为	liang'cai'er'wei	1
量才录用	liang'cai'lu'yong	1
良辰吉日	liang'chen'ji'ri	1
良辰美景	liang'chen'mei'jing	1
两豆塞耳	liang'er'sai'dou	1
良工巧匠	liang'gong'qiao'jiang	1
良工心苦	liang'gong'xin'ku	1
两瞽相扶	liang'gu'xiang'fu	1
两虎相斗	liang'hu'xiang'dou	1
两脚书橱	liang'jiao'shu'chu	1
两脚野狐	liang'jiao'ye'hu	1
良金美玉	liang'jin'mei'yu	1
粮尽援绝	liang'jin'yuan'jue	1
量力度德	liang'li'duo'de	1
量力而行	liang'li'er'xing	1
梁孟相敬	liang'meng'xiang'jin	1
两面二舌	liang'mian'er'she	1
两面三刀	liang'mian'san'dao	1
量能授官	liang'neng'shou'guan	1
良禽择木	liang'qin'ze'mu	1
两全其美	liang'quan'qi'mei	1
量入为出	liang'ru'wei'chu	1
梁上君子	liang'shang'jun'zi	1
两世为人	liang'shi'wei'ren	1
良师益友	liang'shi'yi'you	1
两手空空	liang'shou'kong'kong	1
两鼠斗穴	liang'shu'dou'xue	1
量体裁衣	liang'ti'cai'yi	1
两头白面	liang'tou'bai'mian	1
两相情愿	liang'xiang'qing'yuan	1
量小力微	liang'xiao'li'wei	1
两小无猜	liang'xiao'wu'cai	1
两袖清风	liang'xiu'qing'feng	1
良药苦口	liang'yao'ku'kou	1
两叶掩目	liang'ye'yan'mu	1
良莠不齐	liang'you'bu'qi	1
良知良能	liang'zhi'liang'neng	1
聊备一格	liao'bei'yi'ge	1
聊表寸心	liao'biao'cun'xin	1
了不可见	liao'bu'ke'jian	1
了不长进	liao'bu'zhang'jin	1
蓼虫忘辛	liao'chong'wang'xin	1
料敌若神	liao'di'ruo'shen	1
料敌制胜	liao'di'zhi'sheng	1
辽东白豕	liao'dong'bai'shi	1
燎发摧枯	liao'fa'cui'ku	1
撩蜂剔蝎	liao'feng'ti'xie	1
聊复尔耳	liao'fu'er'er	1
寥寥可数	liao'liao'ke'shu	1
寥寥无几	liao'liao'wu'ji	1
料峭春寒	liao'qiao'chun'han	1
了然于胸	liao'ran'yu'xiong	1
了如指掌	liao'ru'zhi'zhang	1
寥若晨星	liao'ruo'chen'xing	1
了身达命	liao'shen'da'ming	1
聊胜一筹	liao'sheng'yi'chou	1
聊胜于无	liao'sheng'yu'wu	1
料事如神	liao'shi'ru'shen	1
聊以解嘲	liao'yi'jie'chao	1
聊以塞责	liao'yi'se'ze	1
聊以自慰	liao'yi'zi'wei	1
聊以自娱	liao'yi'zi'yu	1
聊以卒岁	liao'yi'zu'sui	1
燎原烈火	liao'yuan'lie'huo	1
列鼎而食	lie'ding'er'shi	1
列风淫雨	lie'feng'yin'yu	1
烈火辨日	lie'huo'bian'ri	1
烈火轰雷	lie'huo'hong'lei	1
烈火烹油	lie'huo'peng'you	1
劣迹昭著	lie'ji'zhao'zhu	1
烈烈轰轰	lie'lie'hong'hong	1
裂石穿云	lie'shi'chuan'yun	1
裂土分茅	lie'tu'fen'mao	1
列土封疆	lie'tu'feng'jiang	1
临财不苟	lin'cai'bu'gou	1
临池学书	lin'chi'xue'shu	1
鳞次栉比	lin'ci'zhi'bi	1
临敌易将	lin'di'yi'jiang	1
麟凤龟龙	lin'feng'gui'long	1
麟凤一毛	lin'feng'yi'mao	1
林寒洞肃	lin'han'dong'su	1
临机应变	lin'ji'ying'bian	1
麟角凤距	lin'jiao'feng'ju	1
麟角凤嘴	lin'jiao'feng'zui	1
麟角凤觜	lin'jiao'feng'zui	1
临渴穿井	lin'ke'chuan'jing	1
临渴掘井	lin'ke'jue'jing	1
琳琅满目	lin'lang'man'mu	1
淋漓尽致	lin'li'jin'zhi	1
林林总总	lin'lin'zong'zong	1
临难苟免	lin'nan'gou'mian	1
临难铸兵	lin'nan'zhu'bing	1
凛若冰霜	lin'ruo'bing'shuang	1
临深履薄	lin'shen'lv'bo	1
临事而惧	lin'shi'er'ju	1
临潼斗宝	lin'tong'dou'bao	1
临危不惧	lin'wei'bu'ju	1
临危受命	lin'wei'shou'ming	1
临危授命	lin'wei'shou'ming	1
临危致命	lin'wei'zhi'ming	1
临文不讳	lin'wen'bu'hui	1
林下风范	lin'xia'feng'fan	1
林下风气	lin'xia'feng'qi	1
临渊羡鱼	lin'yuan'xian'yu	1
临阵磨枪	lin'zhen'mo'qiang	1
临阵脱逃	lin'zhen'tuo'tao	1
麟趾呈祥	lin'zhi'cheng'xiang	1
令不虚行	ling'bu'xu'xing	1
零打碎敲	ling'da'sui'qiao	1
灵丹妙药	ling'dan'miao'yao	1
灵丹圣药	ling'dan'sheng'yao	1
伶仃孤苦	ling'ding'gu'ku	1
零丁孤苦	ling'ding'gu'ku	1
陵谷变迁	ling'gu'bian'qian	1
灵机一动	ling'ji'yi'dong	1
玲珑剔透	ling'long'ti'tou	1
零七八碎	ling'qi'ba'sui	1
另起炉灶	ling'qi'lu'zao	1
零敲碎打	ling'qiao'sui'da	1
令人齿冷	ling'ren'chi'leng	1
令人发指	ling'ren'fa'zhi	1
令人莫测	ling'ren'mo'ce	1
令人喷饭	ling'ren'pen'fan	1
令人起敬	ling'ren'qi'jing	1
令人神往	ling'ren'shen'wang	1
令人作呕	ling'ren'zuo'ou	1
凌弱暴寡	ling'ruo'bao'gua	1
凌上虐下	ling'shang'nve'xia	1
灵蛇之珠	ling'she'zhi'zhu	1
令行禁止	ling'xing'jin'zhi	1
伶牙俐齿	ling'ya'li'chi	1
另眼相看	ling'yan'xiang'kan	1
羚羊挂角	ling'yang'gua'jiao	1
凌云之志	ling'yun'zhi'zhi	1
凌杂米盐	ling'za'mi'yan	1
柳暗花明	liu'an'hua'ming	1
六朝金粉	liu'chao'jin'fen	1
六尺之孤	liu'chi'zhi'gu	1
六畜不安	liu'chu'bu'an	1
六出纷飞	liu'chu'fen'fei	1
六出奇计	liu'chu'qi'ji	1
流芳百世	liu'fang'bai'shi	1
流风余韵	liu'feng'yu'yun	1
六根清静	liu'gen'qing'jing	1
流光易逝	liu'guang'yi'shi	1
六合之内	liu'he'zhi'nei	1
六街三市	liu'jie'san'shi	1
流金铄石	liu'jin'shuo'shi	1
流离颠沛	liu'li'dian'pei	1
流离失所	liu'li'shi'suo	1
流离琐尾	liu'li'suo'wei	1
流离转徙	liu'li'zhuan'xi	1
流连忘返	liu'lian'wang'fan	1
流落江湖	liu'luo'jiang'hu	1
柳绿花红	liu'lv'hua'hong	1
六马仰秣	liu'ma'yang'mo	1
流年不利	liu'nian'bu'li	1
流年似水	liu'nian'si'shui	1
六亲不认	liu'qin'bu'ren	1
六亲无靠	liu'qin'wu'kao	1
六神无主	liu'shen'wu'zhu	1
流水朝宗	liu'shui'chao'zong	1
流水落花	liu'shui'luo'hua	1
流水桃花	liu'shui'tao'hua	1
流水无情	liu'shui'wu'qing	1
六韬三略	liu'tao'san'lve	1
柳下借阴	liu'xia'jie'yin	1
流星赶月	liu'xing'gan'yue	1
流行坎止	liu'xing'kan'zhi	1
柳絮才高	liu'xu'cai'gao	1
溜须拍马	liu'xu'pai'ma	1
流言蜚语	liu'yan'fei'yu	1
流言惑众	liu'yan'huo'zhong	1
六月飞霜	liu'yue'fei'shuang	1
溜之大吉	liu'zhi'da'ji	1
溜之乎也	liu'zhi'hu'ye	1
龙飞凤舞	long'fei'feng'wu	1
龙凤呈祥	long'feng'cheng'xiang	1
龙肝豹胎	long'gan'bao'tai	1
龙肝凤脑	long'gan'feng'nao	1
龙肝凤髓	long'gan'feng'sui	1
龙驹凤雏	long'ju'feng'chu	1
笼络人心	long'luo'ren'xin	1
龙马精神	long'ma'jing'shen	1
龙鸣狮吼	long'ming'shi'hou	1
龙蟠凤逸	long'pan'feng'yi	1
龙盘虎踞	long'pan'hu'ju	1
龙蟠虎踞	long'pan'hu'ju	1
龙蛇飞动	long'she'fei'dong	1
龙蛇混杂	long'she'hun'za	1
龙生九子	long'sheng'jiu'zi	1
龙潭虎窟	long'tan'hu'ku	1
龙潭虎穴	long'tan'hu'xue	1
龙腾虎跃	long'teng'hu'yue	1
龙跳虎卧	long'tiao'hu'wo	1
龙骧虎步	long'xiang'hu'bu	1
龙骧虎视	long'xiang'hu'shi	1
龙行虎步	long'xing'hu'bu	1
龙血玄黄	long'xue'xuan'huang	1
龙吟虎啸	long'yin'hu'xiao	1
龙跃凤鸣	long'yue'feng'ming	1
龙章凤姿	long'zhang'feng'zi	1
龙争虎斗	long'zheng'hu'dou	1
笼中之鸟	long'zhong'zhi'niao	1
镂尘吹影	lou'chen'chui'ying	1
漏洞百出	lou'dong'bai'chu	1
漏脯充饥	lou'fu'chong'ji	1
镂骨铭心	lou'gu'ming'xin	1
镂金错彩	lou'jin'cuo'cai	1
漏尽更阑	lou'jin'geng'lan	1
楼台亭阁	lou'tai'ting'ge	1
漏网之鱼	lou'wang'zhi'yu	1
陋巷箪瓢	lou'xiang'dan'piao	1
漏泄春光	lou'xie'chun'guang	1
镂心刻骨	lou'xin'ke'gu	1
蝼蚁贪生	lou'yi'tan'sheng	1
镂月裁云	lou'yue'cai'yun	1
漏卮难满	lou'zhi'nan'man	1
路不拾遗	lu'bu'shi'yi	1
露才扬己	lu'cai'yang'ji	1
鹿车共挽	lu'che'gong'wan	1
鲁殿灵光	lu'dian'ling'guang	1
路断人稀	lu'duan'ren'xi	1
陆海潘江	lu'hai'pan'jiang	1
炉火纯青	lu'huo'chun'qing	1
戮力同心	lu'li'tong'xin	1
绿林好汉	lu'lin'hao'han	1
绿林豪客	lu'lin'hao'ke	1
路柳墙花	lu'liu'qiang'hua	1
碌碌无能	lu'lu'wu'neng	1
碌碌无为	lu'lu'wu'wei	1
碌碌无闻	lu'lu'wu'wen	1
鲁莽灭裂	lu'mang'mie'lie	1
鹿裘不完	lu'qiu'bu'wan	1
路人皆知	lu'ren'jie'zhi	1
鹿死谁手	lu'si'shui'shou	1
露宿风餐	lu'su'feng'can	1
鲁鱼帝虎	lu'yu'di'hu	1
鲁鱼亥豕	lu'yu'hai'shi	1
鹿走苏台	lu'zou'su'tai	1
乱臣贼子	luan'chen'zei'zi	1
乱点鸳鸯	luan'dian'yuan'yang	1
鸾飞凤舞	luan'fei'feng'wu	1
鸾凤和鸣	luan'feng'he'ming	1
卵覆鸟飞	luan'fu'niao'fei	1
鸾歌凤舞	luan'ge'feng'wu	1
鸾孤凤只	luan'gu'feng'zhi	1
乱箭攒心	luan'jian'cuan'xin	1
鸾交凤友	luan'jiao'feng'you	1
鸾飘凤泊	luan'piao'feng'bo	1
乱七八糟	luan'qi'ba'zao	1
乱琼碎玉	luan'qiong'sui'yu	1
卵石不敌	luan'shi'bu'di	1
乱世英雄	luan'shi'ying'xiong	1
乱头粗服	luan'tou'cu'fu	1
鸾翔凤集	luan'xiang'feng'ji	1
鸾翔凤翥	luan'xiang'feng'zhu	1
卵与石斗	luan'yu'shi'dou	1
轮扁斫轮	lun'bian'zhuo'lun	1
论甘忌辛	lun'gan'ji'xin	1
论功行赏	lun'gong'xing'shang	1
论黄数黑	lun'huang'shu'hei	1
沦肌浃髓	lun'ji'jiam'sui	1
沦落风尘	lun'luo'feng'chen	1
纶音佛语	lun'yin'fo'yu	1
裸裎袒裼	luo'cheng'tan'xi	1
罗敷有夫	luo'fu'you'fu	1
锣鼓喧天	luo'gu'xuan'tian	1
落花流水	luo'hua'liu'shui	1
落花无言	luo'hua'wu'yan	1
落荒而逃	luo'huang'er'tao	1
落井下石	luo'jing'xia'shi	1
罗掘一空	luo'jue'yi'kong	1
荦荦大端	luo'luo'da'duan	1
落落大方	luo'luo'da'fang	1
落落寡合	luo'luo'gua'he	1
落落穆穆	luo'luo'mu'mu	1
落落难合	luo'luo'nan'he	1
落魄不羁	luo'po'bu'ji	1
罗雀掘鼠	luo'que'jue'shu	1
落汤螃蟹	luo'tang'pang'xie	1
落拓不羁	luo'tuo'bu'ji	1
洛阳纸贵	luo'yang'zhi'gui	1
落叶归根	luo'ye'gui'gen	1
落叶知秋	luo'ye'zhi'qiu	1
络绎不绝	luo'yi'bu'jue	1
骆驿不绝	luo'yi'bu'jue	1
落英缤纷	luo'ying'bin'fen	1
落月屋梁	luo'yue'wu'liang	1
罗织构陷	luo'zhi'gou'xian	1
履薄临深	lv'bo'lin'shen	1
履穿踵决	lv'chuan'zhong'jue	1
屡次三番	lv'ci'san'fan	1
绿肥红瘦	lv'fei'hong'shou	1
屡教不改	lv'jian'bu'gai	1
屡见不鲜	lv'jian'bu'xian	1
旅进旅退	lv'jin'lv'tui	1
驴鸣犬吠	lv'ming'quan'fei	1
驴前马后	lv'qian'ma'hou	1
屡试不爽	lv'shi'bu'shuang	1
履霜坚冰	lv'shuang'jian'bing	1
履霜之戒	lv'shuang'zhi'jie	1
绿水青山	lv'shui'qing'shan	1
绿蓑青笠	lv'suo'qing'li	1
履舄交错	lv'xi'jiao'cuo	1
履险如夷	lv'xian'ru'yi	1
驴心狗肺	lv'xin'gou'fei	1
绿叶成阴	lv'ye'cheng'yin	1
绿衣黄里	lv'yi'huang'li	1
绿衣使者	lv'yi'shi'zhe	1
屡战屡败	lv'zhan'lv'bai	1
掠地攻城	lve'di'gong'cheng	1
略高一筹	lve'gao'yi'chou	1
略迹原情	lve'ji'yuan'qing	1
略见一斑	lve'jian'yi'ban	1
掠人之美	lve'ren'zhi'mei	1
略胜一筹	lve'sheng'yi'chou	1
略识之无	lve'shi'zhi'wu	1
略逊一筹	lve'xun'yi'chou	1
麻痹大意	ma'bi'da'yi	1
马不停蹄	ma'bu'ting'ti	1
马齿徒增	ma'chi'tu'zeng	1
马到成功	ma'dao'cheng'gong	1
马耳东风	ma'er'dong'feng	1
马革裹尸	ma'ge'guo'shi	1
马工枚速	ma'gong'mei'su	1
马角乌白	ma'jiao'wu'bai	1
马空冀北	ma'kong'ji'bei	1
马鹿异形	ma'lu'yi'xing	1
麻木不仁	ma'mu'bu'ren	1
马牛襟裾	ma'niu'jin'ju	1
马瘦毛长	ma'shou'mao'chang	1
马首是瞻	ma'shou'shi'zhan	1
马仰人翻	ma'yang'ren'fan	1
买菜求益	mai'cai'qiu'yi	1
买椟还珠	mai'du'huan'zhu	1
卖儿鬻女	mai'er'yu'nv	1
卖官鬻爵	mai'guan'yu'jue	1
卖国求荣	mai'guo'qiu'rong	1
卖剑买牛	mai'jian'mai'niu	1
买空卖空	mai'kong'mai'kong	1
卖李钻核	mai'li'zuan'he	1
卖履分香	mai'lv'fen'xiang	1
卖身投靠	mai'shen'tou'kao	1
麦穗两歧	mai'sui'liang'qi	1
买田阳羡	mai'tian'yang'xian	1
埋头苦干	mai'tou'ku'gan	1
蛮不讲理	man'bu'jiang'li	1
漫不经心	man'bu'jing'xin	1
满不在乎	man'bu'zai'hu	1
慢藏诲盗	man'cang'hui'dao	1
蔓草难除	man'cao'nan'chu	1
满城风雨	man'cheng'feng'yu	1
蛮触相争	man'chu'xiang'zheng	1
满打满算	man'da'man'suan	1
满腹狐疑	man'fu'hu'yi	1
满腹经纶	man'fu'jing'lun	1
满腹疑团	man'fu'yi'tuan	1
满谷满坑	man'gu'man'keng	1
蛮横无理	man'heng'wu'li	1
满坑满谷	man'keng'man'gu	1
蛮来生作	man'lai'sheng'zuo	1
蔓蔓日茂	man'man'ri'mao	1
满面春风	man'mian'chun'feng	1
满目疮痍	man'mu'chuang'yi	1
满盘皆输	man'pan'jie'shu	1
满腔热枕	man'qiang're'chen	1
漫山遍野	man'shan'bian'ye	1
瞒上欺下	man'shang'qi'xia	1
瞒天过海	man'tian'guo'hai	1
慢条斯理	man'tiao'si'li	1
漫无边际	man'wu'bian'ji	1
瞒心昧己	man'xin'mei'ji	1
蛮烟瘴雨	man'yan'zhang'yu	1
慢易生忧	man'yi'sheng'you	1
蔓引株求	man'yin'zhu'qiu	1
满园春色	man'yuan'chun'se	1
满载而归	man'zai'er'gui	1
满纸空言	man'zhi'kong'yan	1
芒刺在背	mang'ci'zai'bei	1
芒寒色正	mang'han'se'zheng	1
忙里偷闲	mang'li'tou'xian	1
盲人把烛	mang'ren'ba'zhu	1
盲人摸象	mang'ren'mo'xiang	1
盲人瞎马	mang'ren'xia'ma	1
茫无头绪	mang'wu'tou'xu	1
盲者得镜	mang'zhe'de'jing	1
茅茨土阶	mao'ci'tu'jie	1
毛发丝粟	mao'fa'si'su	1
毛发之功	mao'fa'zhi'gong	1
毛骨悚然	mao'gu'song'ran	1
貌合神离	mao'he'shen'li	1
貌合心离	mao'he'xin'li	1
毛举细务	mao'ju'xi'wu	1
茂林修竹	mao'lin'xiu'zhu	1
冒名顶替	mao'ming'ding'ti	1
茅塞顿开	mao'se'dun'kai	1
貌是情非	mao'shi'qing'fei	1
毛手毛脚	mao'shou'mao'jiao	1
贸首之仇	mao'shou'zhi'chou	1
猫鼠同眠	mao'shu'tong'mian	1
貌似强大	mao'si'qiang'da	1
毛遂自荐	mao'sui'zi'jian	1
毛羽零落	mao'yu'ling'luo	1
美不胜收	mei'bu'sheng'shou	1
每饭不忘	mei'fan'bu'wang	1
眉飞色舞	mei'fei'se'wu	1
眉高眼低	mei'gao'yan'di	1
眉睫之祸	mei'jie'zhi'huo	1
眉睫之内	mei'jie'zhi'nei	1
没精打采	mei'jing'da'cai	1
眉开眼笑	mei'kai'yan'xiao	1
每况愈下	mei'kuang'yu'xia	1
眉来眼去	mei'lai'yan'qu	1
美轮美奂	mei'lun'mei'huan	1
眉目如画	mei'mu'ru'hua	1
美女簪花	mei'nv'zan'hua	1
美芹之献	mei'qin'zhi'xian	1
眉清目秀	mei'qing'mu'xiu	1
美人迟暮	mei'ren'chi'mu	1
美人香草	mei'ren'xiang'cao	1
美如冠玉	mei'ru'guan'yu	1
眉头不伸	mei'tou'bu'shen	1
没头没脑	mei'tou'mei'nao	1
每下愈况	mei'xia'yu'kuang	1
美意延年	mei'yi'yan'nian	1
袂云汗雨	mei'yun'han'yu	1
美中不足	mei'zhong'bu'zu	1
门不停宾	men'bu'ting'bin	1
门当户对	men'dang'hu'dui	1
门到户说	men'dao'hu'shuo	1
门户之见	men'hu'zhi'jian	1
门禁森严	men'jin'sen'yan	1
门可罗雀	men'ke'luo'que	1
门闾之望	men'lv'zhi'wang	1
闷闷不乐	men'men'bu'le	1
门墙桃李	men'qiang'tao'li	1
门生故吏	men'sheng'gu'li	1
扪虱而谈	men'shi'er'tan	1
门庭若市	men'ting'ruo'shi	1
门无杂宾	men'wu'za'bin	1
扪心无愧	men'xin'wu'kui	1
扪心自问	men'xin'zi'wen	1
梦笔生花	meng'bi'sheng'hua	1
梦幻泡影	meng'huan'pao'ying	1
蒙混过关	meng'hun'guo'guan	1
蒙袂辑屦	meng'mei'ji'ju	1
蒙昧无知	meng'mei'wu'zhi	1
梦寐以求	meng'mei'yi'qiu	1
孟母三迁	meng'mu'san'qian	1
蒙以养正	meng'yi'yang'zheng	1
蒙在鼓里	meng'zai'gu'li	1
猛志常在	meng'zhi'chang'zai	1
梦中说梦	meng'zhong'shuo'meng	1
密不通风	mi'bu'tong'feng	1
秘而不宣	mi'er'bu'xuan	1
麋沸蚁动	mi'fei'yi'dong	1
弥缝其阙	mi'feng'qi'que	1
迷惑视听	mi'huo'shi'ting	1
迷离惝恍	mi'li'chang'huang	1
迷离恍惚	mi'li'huang'hu	1
迷离扑朔	mi'li'pu'shuo	1
蜜里调油	mi'li'tiao'you	1
迷恋骸骨	mi'lian'hai'gu	1
弥留之际	mi'liu'zhi'ji	1
密锣紧鼓	mi'luo'jin'gu	1
靡靡之音	mi'mi'zhi'yin	1
迷人眼目	mi'ren'yan'mu	1
弥天大谎	mi'tian'da'huang	1
弥天大罪	mi'tian'da'zui	1
迷头认影	mi'tou'ren'ying	1
迷途知返	mi'tu'zhi'fan	1
靡颜腻理	mi'yan'ni'li	1
靡衣媮食	mi'yi'tou'shi	1
靡有孑遗	mi'you'jie'yi	1
密约偷期	mi'yue'tou'qi	1
密云不雨	mi'yun'bu'yu	1
米珠薪桂	mi'zhu'xin'gui	1
面壁功深	mian'bi'gong'shen	1
面不改色	mian'bu'gai'se	1
面缚舆榇	mian'fu'yu'chen	1
偭规越矩	mian'gui'yue'ju	1
面红耳赤	mian'hong'er'chi	1
面黄肌瘦	mian'huang'ji'shou	1
免开尊口	mian'kai'zun'kou	1
绵里薄材	mian'li'bo'cai	1
绵里藏针	mian'li'cang'zhen	1
绵绵瓜瓞	mian'mian'gua'die	1
面面俱到	mian'mian'ju'dao	1
面面相觑	mian'mian'xiang'qu	1
面命耳提	mian'ming'er'ti	1
面目可憎	mian'mu'ke'zeng	1
面目全非	mian'mu'quan'fei	1
面目一新	mian'mu'yi'xin	1
面墙而立	mian'qiang'er'li	1
面如傅粉	mian'ru'fu'fen	1
面如冠玉	mian'ru'guan'yu	1
面如土色	mian'ru'tu'se	1
眄视指使	mian'shi'zhi'shi	1
面授机宜	mian'shou'ji'yi	1
面似靴皮	mian'si'xue'pi	1
勉为其难	mian'wei'qi'nan	1
面无人色	mian'wu'ren'se	1
面有菜色	mian'you'cai'se	1
面折廷争	mian'zhe'ting'zheng	1
妙不可言	miao'bu'ke'yan	1
妙处不传	miao'chu'bu'chuan	1
苗而不秀	miao'er'bu'xiu	1
妙绝时人	miao'jue'shi'ren	1
妙趣横生	miao'qu'heng'sheng	1
妙手丹青	miao'shou'dan'qing	1
妙手回春	miao'shou'hui'chun	1
妙手空空	miao'shou'kong'kong	1
妙手偶得	miao'shou'ou'de	1
描写画角	miao'xie'hua'jiao	1
妙言要道	miao'yan'yao'dao	1
妙语解烦	miao'yu'jie'fan	1
妙语解颐	miao'yu'jie'yi	1
灭此朝食	mie'ci'zhao'shi	1
灭顶之灾	mie'ding'zhi'zai	1
灭虢取虞	mie'guo'qu'yu	1
灭绝人性	mie'jue'ren'xing	1
灭门绝户	mie'men'jue'hu	1
民胞物与	min'bao'wu'yu	1
民保于信	min'bao'yu'xin	1
民不堪命	min'bu'kan'ming	1
民不聊生	min'bu'liao'sheng	1
民富国强	min'fu'guo'qiang	1
民和年丰	min'he'nian'feng	1
民康物阜	min'kang'wu'fu	1
民穷财尽	min'qiong'cai'jin	1
民穷财匮	min'qiong'cai'kui	1
民生凋敝	min'sheng'diao'bi	1
民殷财阜	min'yin'cai'fu	1
民怨沸腾	min'yuan'fei'teng	1
民脂民膏	min'zhi'min'gao	1
明白了当	ming'bai'liao'dang	1
明辨是非	ming'bian'shi'fei	1
名标青史	ming'biao'qing'shi	1
名不副实	ming'bu'fu'shi	1
名不虚传	ming'bu'xu'chuan	1
明察暗访	ming'cha'an'fang	1
明察秋毫	ming'cha'qiu'hao	1
明耻教战	ming'chi'jiao'zhan	1
命俦啸侣	ming'chou'xiao'lv	1
明窗净几	ming'chuang'jing'ji	1
名垂后世	ming'chui'hou'shi	1
名垂千古	ming'chui'qian'gu	1
名垂青史	ming'chui'qing'shi	1
名垂竹帛	ming'chui'zhu'bo	1
名存实亡	ming'cun'shi'wang	1
明德惟馨	ming'de'wei'xin	1
酩酊大醉	ming'ding'da'zui	1
明发不寐	ming'fa'bu'mei	1
名副其实	ming'fu'qi'shi	1
铭感五内	ming'gan'wu'nei	1
名高天下	ming'gao'tian'xia	1
名过其实	ming'guo'qi'shi	1
明火执杖	ming'huo'zhi'zhang	1
铭记不忘	ming'ji'bu'wang	1
铭肌镂骨	ming'ji'lou'gu	1
明见万里	ming'jian'wan'li	1
名缰利锁	ming'jiang'li'suo	1
明教不变	ming'jiao'bu'bian	1
明镜高悬	ming'jing'gao'xuan	1
明来暗往	ming'lai'an'wang	1
名利双收	ming'li'shuang'shou	1
名列前茅	ming'lie'qian'mao	1
鸣锣喝道	ming'luo'he'dao	1
鸣锣开道	ming'luo'kai'dao	1
名落孙山	ming'luo'sun'shan	1
名满天下	ming'man'tian'xia	1
名贸实易	ming'mao'shi'yi	1
明媒正娶	ming'mei'zheng'qu	1
明明赫赫	ming'ming'he'he	1
明眸皓齿	ming'mou'hao'chi	1
明眸善睐	ming'mou'shan'lai	1
明目达聪	ming'mu'da'cong	1
名目繁多	ming'mu'fan'duo	1
明目张胆	ming'mu'zhang'dan	1
明枪暗箭	ming'qiang'an'jian	1
鸣琴而治	ming'qin'er'zhi	1
明日黄花	ming'ri'huang'hua	1
明若观火	ming'ruo'guan'huo	1
名山大川	ming'shan'da'chuan	1
名山胜川	ming'shan'sheng'chuan	1
名山事业	ming'shan'shi'ye	1
明赏不费	ming'shang'bu'fei	1
名声籍甚	ming'sheng'ji'shen	1
名士风流	ming'shi'feng'liu	1
名实难副	ming'shi'nan'fu	1
名实相副	ming'shi'xiang'fu	1
冥思苦索	ming'si'ku'suo	1
冥思苦想	ming'si'ku'xiang	1
冥顽不灵	ming'wan'bu'ling	1
名下无虚	ming'xia'wu'xu	1
明效大验	ming'xiao'da'ya	1
铭心镂骨	ming'xin'lou'gu	1
明刑弼教	ming'xing'bi'jiao	1
明刑不戮	ming'xing'bu'lu	1
冥行盲索	ming'xing'mang'suo	1
冥行擿埴	ming'xing'zhi'zhi	1
明扬侧陋	ming'yang'ce'lou	1
鸣野食苹	ming'ye'shi'ping	1
明月清风	ming'yue'qing'feng	1
明月入怀	ming'yue'ru'huai	1
明哲保身	ming'zhe'bao'shen	1
名震一时	ming'zhen'yi'shi	1
明争暗斗	ming'zheng'an'dou	1
明正典刑	ming'zheng'dian'xing	1
名正言顺	ming'zheng'yan'shun	1
明知故犯	ming'zhi'gu'fan	1
明知故问	ming'zhi'gu'wen	1
命中注定	ming'zhong'zhu'ding	1
明珠暗投	ming'zhu'an'tou	1
铭诸肺腑	ming'zhu'fei'fu	1
明珠弹雀	ming'zhu'tan'que	1
谬种流传	miu'zhong'liu'chuan	1
莫辨楮叶	mo'bian'chu'ye	1
漠不关心	mo'bu'guan'xin	1
漠不相关	mo'bu'xiang'guan	1
莫测高深	mo'ce'gao'shen	1
没齿不忘	mo'chi'bu'wang	1
没齿无怨	mo'chi'wu'yuan	1
磨杵成针	mo'chu'cheng'zhen	1
磨穿铁砚	mo'chuan'tie'yan	1
莫此为甚	mo'ci'wei'shen	1
磨刀霍霍	mo'dao'huo'huo	1
摩顶放踵	mo'ding'fang'zhong	1
莫敢谁何	mo'gan'shui'he	1
墨迹未干	mo'ji'wei'gan	1
摩肩击毂	mo'jian'ji'gu	1
摩肩接踵	mo'jian'jie'zhong	1
摸金校尉	mo'jin'xiao'wei	1
莫可究诘	mo'ke'jiu'jie	1
莫可名状	mo'ke'ming'zhuang	1
模棱两可	mo'leng'liang'ke	1
摩厉以须	mo'li'yi'xu	1
磨砺以须	mo'li'yi'xu	1
末路之难	mo'lu'zhi'nan	1
秣马厉兵	mo'ma'li'bing	1
莫名其妙	mo'ming'qi'miao	1
莫明其妙	mo'ming'qi'miao	1
脉脉含情	mo'mo'han'qing	1
没没无闻	mo'mo'wu'wen	1
默默无闻	mo'mo'wu'wen	1
默默无言	mo'mo'wu'yan	1
莫逆之交	mo'ni'zhi'jiao	1
摩拳擦掌	mo'quan'ca'zhang	1
漠然置之	mo'ran'zhi'zhi	1
没世不忘	mo'shi'bu'wang	1
墨守成规	mo'shou'cheng'gui	1
莫为已甚	mo'wei'yi'shen	1
末学肤受	mo'xue'fu'shou	1
莫予毒也	mo'yu'du'ye	1
莫余毒也	mo'yu'du'ye	1
抹月秕风	mo'yue'pi'feng	1
墨汁未干	mo'zhi'wei'gan	1
莫衷一是	mo'zhong'yi'shi	1
磨砖成镜	mo'zhuan'cheng'jing	1
墨子泣丝	mo'zi'qi'si	1
谋财害命	mou'cai'hai'ming	1
侔色揣称	mou'se'chuai'chen	1
谋为不轨	mou'wei'bu'gui	1
木本水源	mu'ben'shui'yuan	1
目不见睫	mu'bu'jian'jie	1
目不交睫	mu'bu'jiao'jie	1
目不窥园	mu'bu'kui'yuan	1
目不识丁	mu'bu'shi'ding	1
目不暇接	mu'bu'xia'jie	1
目不邪视	mu'bu'xie'shi	1
目不转睛	mu'bu'zhuan'jing	1
目瞪口呆	mu'deng'kou'dai	1
木雕泥塑	mu'diao'ni'su	1
暮鼓晨钟	mu'gu'chen'zhong	1
目光炯炯	mu'guang'jiong'jiong	1
目光如豆	mu'guang'ru'dou	1
目光如炬	mu'guang'ru'ju	1
目光如鼠	mu'guang'ru'shu	1
暮虢朝虞	mu'guo'zhao'yu	1
沐猴而冠	mu'hou'er'guan	1
目击耳闻	mu'ji'er'wen	1
木鸡养到	mu'ji'yang'dao	1
目空一切	mu'kong'yi'qie	1
目迷五色	mu'mi'wu'se	1
墓木已拱	mu'mu'yi'gong	1
木人石心	mu'ren'shi'xin	1
目濡耳染	mu'ru'er'ran	1
目食耳视	mu'shi'er'shi	1
牧豕听经	mu'shi'ting'jing	1
目使颐令	mu'shi'yi'ling	1
目送手挥	mu'song'shou'hui	1
幕天席地	mu'tian'xi'di	1
目挑心招	mu'tiao'xin'zhao	1
目无全牛	mu'wu'quan'niu	1
目无余子	mu'wu'yu'zi	1
暮夜怀金	mu'ye'huai'jin	1
木已成舟	mu'yi'cheng'zhou	1
母以子贵	mu'yi'zi'gui	1
沐雨栉风	mu'yu'zhi'feng	1
暮云春树	mu'yun'chun'shu	1
目指气使	mu'zhi'qi'shi	1
目中无人	mu'zhong'wu'ren	1
牧猪奴戏	mu'zhou'nu'xi	1
拿班作势	na'ban'zuo'shi	1
拿粗夹细	na'cu'jia'xi	1
拿刀动杖	na'dao'dong'zhang	1
纳屦踵决	na'ju'zhong'jue	1
拿腔作势	na'qiang'zuo'shi	1
拿三搬四	na'san'ban'si	1
拿手好戏	na'shou'hao'xi	1
拿糖作醋	na'tang'zuo'cu	1
拿云握雾	na'yun'wo'wu	1
耐人寻味	nai'ren'xun'wei	1
乃心王室	nai'xin'wang'shi	1
男盗女娼	nan'dao'nv'chang	1
南贩北贾	nan'fan'bei'gu	1
难分难解	nan'fen'nan'jie	1
南风不竞	nan'feng'bu'jing	1
男耕女织	nan'geng'nv'zhi	1
难更仆数	nan'geng'pu'shu	1
南冠楚囚	nan'guan'chu'qiu	1
难乎为继	nan'hu'wei'ji	1
男欢女爱	nan'huan'nv'ai	1
男婚女嫁	nan'hun'nv'jia	1
南箕北斗	nan'ji'bei'dou	1
难解难分	nan'jie'nan'fen	1
南金东箭	nan'jin'dong'jian	1
南柯一梦	nan'ke'yi'meng	1
南来北往	nan'lai'bei'wang	1
南面百城	nan'mian'bai'cheng	1
难能可贵	nan'neng'ke'gui	1
南腔北调	nan'qiang'bei'diao	1
南阮北阮	nan'ruan'bei'ruan	1
南山可移	nan'shan'ke'yi	1
难兄难弟	nan'xiong'nan'di	1
难兄难弟	nan'xiong'nan'di	1
难言之隐	nan'yan'zhi'yin	1
南鹞北鹰	nan'yao'bei'ying	1
难以为继	nan'yi'wei'ji	1
难以置信	nan'yi'zhi'xin	1
南辕北辙	nan'yuan'bei'zhe	1
南征北战	nan'zheng'bei'zhan	1
南枝北枝	nan'zhi'bei'zhi	1
南州冠冕	nan'zhou'guan'mian	1
男尊女卑	nan'zun'nv'bei	1
囊空如洗	nang'kong'ru'xi	1
囊括四海	nang'kuo'si'hai	1
囊萤照书	nang'ying'zhao'shu	1
囊萤照读	nang'ying'zhao'shu	1
脑满肠肥	nao'man'chang'fei	1
呶呶不休	nao'nao'bu'xiu	1
恼羞成怒	nao'xiu'cheng'nu	1
讷口少言	ne'kou'shao'yan	1
讷言敏行	ne'yan'min'xing	1
内顾之忧	nei'gu'zhi'you	1
内圣外王	nei'sheng'wai'zhu	1
内视反听	nei'shi'fan'ting	1
内外夹攻	nei'wai'jia'gong	1
内外交困	nei'wai'jiao'kun	1
内省不疚	nei'xing'bu'jiu	1
内忧外患	nei'you'wai'huan	1
能不称官	neng'bu'chen'guan	1
能工巧匠	neng'gong'qiao'jiang	1
能近取譬	neng'jin'qu'pi	1
能屈能伸	neng'qu'neng'shen	1
能说会道	neng'shuo'hui'dao	1
能言巧辩	neng'yan'qiao'bian	1
能者多劳	neng'zhe'duo'lao	1
能者为师	neng'zhe'wei'shi	1
能征惯战	neng'zheng'guan'zhan	1
泥船渡河	ni'chuan'du'he	1
泥多佛大	ni'duo'fo'da	1
逆耳之言	ni'er'zhi'yan	1
泥古不化	ni'gu'bu'hua	1
拟规画圆	ni'gui'hua'yuan	1
匿迹销声	ni'ji'xiao'sheng	1
逆来顺受	ni'lai'shun'shou	1
泥牛入海	ni'niu'ru'hai	1
泥蟠不滓	ni'pan'bu'zi	1
逆取顺守	ni'qu'shun'shou	1
泥沙俱下	ni'sha'ju'xia	1
逆水行舟	ni'shui'xing'zhou	1
你死我活	ni'si'wo'huo	1
泥塑木雕	ni'su'mu'diao	1
匿瑕含垢	ni'xia'han'gou	1
匿影藏形	ni'ying'cang'xing	1
拟于不伦	ni'yu'bu'lun	1
泥足巨人	ni'zu'ju'ren	1
年富力强	nian'fu'li'qiang	1
年高德劭	nian'gao'de'shao	1
年高望重	nian'gao'wang'zhong	1
年谷不登	nian'gu'bu'deng	1
拈花惹草	nian'hua're'cao	1
拈花微笑	nian'hua'wei'xiao	1
念念不忘	nian'nian'bu'wang	1
年轻力壮	nian'qing'li'zhuang	1
拈轻怕重	nian'qing'pa'zhong	1
捻神捻鬼	nian'shen'nian'gui	1
年深日久	nian'shen'ri'jiu	1
年谊世好	nian'yi'shi'hao	1
年逾古稀	nian'yu'gu'xi	1
鲇鱼上竹	nian'yu'shang'zhu	1
念兹在兹	nian'zi'zai'zi	1
鸟革翚飞	niao'ge'hui'fei	1
鸟集鳞萃	niao'ji'lin'cui	1
鸟尽弓藏	niao'jin'gong'cang	1
鸟面鹄形	niao'mian'hu'xing	1
袅袅婷婷	niao'niao'ting'ting	1
鸟枪换炮	niao'qiang'huan'pao	1
鸟穷则啄	niao'qiong'ze'zhuo	1
鸟语花香	niao'yu'hua'xiang	1
涅而不缁	nie'er'bu'zi	1
孽根祸胎	nie'gen'huo'tai	1
捏手捏脚	nie'sho'nie'jiao	1
蹑手蹑脚	nie'shou'nie'jiao	1
捏一把汗	nie'yi'ba'han	1
蹑足其间	nie'zu'qi'jian	1
蹑足潜踪	nie'zu'qian'zong	1
宁缺毋滥	ning'que'wu'lan	1
宁死不屈	ning'si'bu'qu	1
凝脂点漆	ning'zhi'dian'qi	1
牛刀割鸡	niu'dao'ge'ji	1
牛刀小试	niu'dao'xiao'shi	1
牛鼎烹鸡	niu'ding'peng'ji	1
牛鬼蛇神	niu'gui'she'shen	1
牛骥同皂	niu'ji'tong'zao	1
牛角挂书	niu'jiao'gua'shu	1
牛溲马勃	niu'sou'ma'bo	1
牛头马面	niu'tou'ma'mian	1
牛衣对泣	niu'yi'dui'qi	1
扭直作曲	niu'zhi'zuo'qu	1
扭转乾坤	niu'zhuan'qian'kun	1
弄鬼掉猴	nong'gui'diao'hou	1
弄假成真	nong'jia'cheng'zhen	1
弄口鸣舌	nong'kou'ming'she	1
浓墨重彩	nong'mo'zhong'cai	1
弄巧成拙	nong'qiao'cheng'zhuo	1
弄瓦之喜	nong'wa'zhi'xi	1
弄性尚气	nong'xing'shang'qi	1
弄虚作假	nong'xu'zuo'jia	1
弄月嘲风	nong'yue'chao'feng	1
弄璋之喜	nong'zhang'zhi'xi	1
浓妆艳裹	nong'zhuang'yan'guo	1
怒不可遏	nu'bu'ke'e	1
怒发冲冠	nu'fa'chong'guan	1
怒火中烧	nu'huo'zhong'shao	1
驽箭离弦	nu'jian'li'xian	1
驽马铅刀	nu'ma'qian'dao	1
驽马十驾	nu'ma'shi'jia	1
怒目而视	nu'mu'er'shi	1
怒目切齿	nu'mu'qie'chi	1
怒猊渴骥	nu'ni'ke'ji	1
怒气冲天	nu'qi'chong'tian	1
怒形于色	nu'xing'yu'se	1
奴颜婢膝	nu'yan'bi'xi	1
奴颜媚骨	nu'yan'mei'gu	1
暖衣饱食	nuan'yi'bao'shi	1
诺诺连声	nuo'nuo'lian'sheng	1
女中尧舜	nv'zhong'yao'shun	1
藕断丝连	ou'duan'si'lian	1
呕心沥血	ou'xin'li'xue	1
偶一为之	ou'yi'wei'zhi	1
爬罗剔抉	pa'luo'ti'jue	1
拍案而起	pai'an'er'qi	1
拍案叫绝	pai'an'jiao'jue	1
拍板成交	pai'ban'cheng'jiao	1
排斥异己	pai'chi'yi'ji	1
排除万难	pai'chu'wan'nan	1
排除异己	pai'chu'yi'ji	1
排糠障风	pai'kang'zhang'feng	1
排难解纷	pai'nan'jie'fen	1
排沙简金	pai'sha'jian'jin	1
排山倒海	pai'shan'dao'hai	1
排山压卵	pai'shan'ya'luan	1
拍手称快	pai'shou'cheng'kuai	1
盘根错节	pan'gen'cuo'jie	1
盘根究底	pan'gen'jiu'di	1
攀龙附凤	pan'long'fu'feng	1
盘龙之癖	pan'long'zhi'pi	1
盘马弯弓	pan'ma'wan'gong	1
判若鸿沟	pan'ruo'hong'gou	1
判若两人	pan'ruo'liang'ren	1
判若天渊	pan'ruo'tian'yuan	1
判若云泥	pan'ruo'yun'ni	1
磐石之安	pan'shi'zhi'an	1
磐石之固	pan'shi'zhi'gu	1
盘游无度	pan'you'wu'du	1
攀辕卧辙	pan'yuan'wo'zhe	1
旁观者清	pang'guan'zhe'qing	1
旁见侧出	pang'jian'ce'chu	1
庞眉皓发	pang'mei'hao'fa	1
旁门左道	pang'men'zuo'dao	1
旁敲侧击	pang'qiao'ce'ji	1
旁求俊彦	pang'qiu'jun'yan	1
庞然大物	pang'ran'da'wu	1
旁若无人	pang'ruo'wu'ren	1
滂沱大雨	pang'tuo'da'yu	1
旁行斜上	pang'xing'xie'shang	1
旁征博引	pang'zheng'bo'yin	1
庖丁解牛	pao'ding'jie'niu	1
炮凤烹龙	pao'feng'peng'long	1
抛戈弃甲	pao'ge'qi'jia	1
刨根问底	pao'gen'wen'di	1
袍笏登场	pao'hu'deng'chang	1
炮火连天	pao'huo'lian'tian	1
抛头露面	pao'tou'lu'mian	1
咆哮如雷	pao'xiao'ru'lei	1
抛砖引玉	pao'zhuan'yin'yu	1
配套成龙	pei'tao'cheng'long	1
佩韦佩弦	pei'wei'pei'xian	1
配享从汜	pei'xiang'cong'si	1
喷薄欲出	pen'bo'yu'chu	1
蓬荜生辉	peng'bi'sheng'hui	1
朋比为奸	peng'bi'wei'jian	1
鹏程万里	peng'cheng'wan'li	1
朋党比周	peng'dang'bi'zhou	1
蓬户瓮牖	peng'hu'weng'you	1
蓬赖麻直	peng'lai'ma'zhi	1
烹龙炮凤	peng'long'pao'feng	1
蓬门筚户	peng'men'bi'hu	1
怦然心动	peng'ran'xin'dong	1
蓬首垢面	peng'shou'gou'mian	1
蓬头垢面	peng'tou'gou'mian	1
蓬头历齿	peng'tou'li'chi	1
弸中彪外	peng'zhong'biao'wai	1
披发文身	pi'fa'wen'shen	1
被发文身	pi'fa'wen'shen	1
被发缨冠	pi'fa'ying'guan	1
被发左衽	pi'fa'zuo'ren	1
蚍蜉戴盆	pi'fu'dai'pen	1
蚍蜉撼树	pi'fu'han'shu	1
匹夫匹妇	pi'fu'pi'fu	1
匹夫无罪	pi'fu'wu'zui	1
匹夫有责	pi'fu'you'ze	1
匹夫之勇	pi'fu'zhi'yong	1
披肝沥胆	pi'gan'li'dan	1
批亢捣虚	pi'gang'dao'xu	1
屁滚尿流	pi'gun'niao'liu	1
被褐怀玉	pi'he'huai'yu	1
披红戴花	pi'hong'dai'hua	1
批红判白	pi'hong'pan'bai	1
否极泰来	pi'ji'tai'lai	1
披坚执锐	pi'jian'zhi'rui	1
披荆斩棘	pi'jing'zhan'ji	1
皮开肉绽	pi'kai'rou'zhan	1
皮里抽肉	pi'li'chou'rou	1
皮里春秋	pi'li'chun'qiu	1
皮里阳秋	pi'li'yang'qiu	1
匹马单枪	pi'ma'dan'qiang	1
披麻救火	pi'ma'jiu'huo	1
匹马只轮	pi'ma'zhi'lun	1
披毛戴角	pi'mao'dai'jiao	1
披毛索靥	pi'mao'suo'yan	1
睥睨一切	pi'ni'yi'qie	1
琵琶别抱	pi'pa'bie'bao	1
枇杷门巷	pi'pa'men'xiang	1
披沙拣金	pi'sha'jian'jin	1
被山带河	pi'shan'dai'he	1
劈头盖脸	pi'tou'gai'lian	1
披头散发	pi'tou'san'fa	1
批郤导窾	pi'xi'dao'kuan	1
皮相之见	pi'xiang'zhi'jian	1
披心相付	pi'xin'xiang'fu	1
披星戴月	pi'xing'dai'yue	1
疲于奔命	pi'yu'ben'ming	1
披榛采兰	pi'zhen'cai'lan	1
片甲不回	pian'jia'bu'hui	1
骈拇枝指	pian'mu'zhi'zhi	1
翩翩公子	pian'pian'gong'zi	1
翩翩起舞	pian'pian'qi'wu	1
翩翩少年	pian'pian'shao'nian	1
翩若惊鸿	pian'ruo'jing'hong	1
胼手胝足	pian'sho'zhi'zu	1
骈四俪六	pian'si'li'liu	1
偏听偏信	pian'ting'piang'xin	1
片瓦无存	pian'wa'wu'cun	1
偏信则暗	pian'xin'ze'an	1
片言折狱	pian'yan'zhe'yu	1
片言只语	pian'yan'zhi'yu	1
片言只字	pian'yan'zhi'zi	1
片纸只字	pian'zhi'yan'zi	1
漂蓬断梗	piao'peng'duan'geng	1
飘瓦虚舟	piao'wa'xu'zhou	1
飘茵落溷	piao'yin'luo'hun	1
贫病交加	pin'bing'jiao'jia	1
贫病交迫	pin'bing'jiao'po	1
贫而乐道	pin'er'le'dao	1
牝鸡司晨	pin'ji'si'chen	1
贫贱骄人	pin'jian'jiao'ren	1
贫贱之交	pin'jian'zhi'jiao	1
牝牡骊黄	pin'mu'li'huang	1
品头评足	pin'tou'ping'zu	1
品竹弹丝	pin'zhu'tan'si	1
贫嘴薄舌	pin'zui'bo'she	1
贫嘴贱舌	pin'zui'jian'she	1
平白无故	ping'bai'wu'gu	1
平步登天	ping'bu'deng'tian	1
平步青云	ping'bu'qing'yun	1
平淡无奇	ping'dan'wu'qi	1
平地风波	ping'di'feng'bo	1
平地楼台	ping'di'lou'tai	1
平分秋色	ping'fen'qiu'se	1
凭几据杖	ping'ji'ju'zhang	1
平流缓进	ping'liu'huan'jin	1
萍飘蓬转	ping'piao'peng'zhuan	1
平铺直叙	ping'pu'zhi'xu	1
平起平坐	ping'qi'ping'zuo	1
凭轼结辙	ping'shi'jie'zhe	1
萍水相逢	ping'shui'xiang'feng	1
评头论足	ping'tou'lun'zu	1
评头品足	ping'tou'pin'zu	1
平头正脸	ping'tou'zheng'lian	1
平心而论	ping'xin'er'lun	1
平心静气	ping'xin'jing'qi	1
凭虚公子	ping'xu'gong'zi	1
平易近人	ping'yi'jin'ren	1
平原督邮	ping'yuan'du'you	1
平治天下	ping'zhi'tian'xia	1
萍踪浪迹	ping'zong'lang'ji	1
破壁飞去	po'bi'fei'qu	1
迫不得已	po'bu'de'yi	1
迫不及待	po'bu'ji'dai	1
破除迷信	po'chu'mi'xin	1
破釜沉舟	po'fu'chen'zhou	1
泼妇骂街	po'fu'ma'jie	1
破觚为圜	po'gu'wei'yuan	1
破瓜之年	po'gua'zhi'nian	1
破罐破摔	po'guan'po'shuai	1
破家县令	po'jia'xian'ling	1
破镜重圆	po'jing'chong'yuan	1
破旧立新	po'jiu'li'xin	1
破矩为圆	po'ju'wei'yuan	1
破门而出	po'men'er'ru	1
婆婆妈妈	po'po'ma'ma	1
婆娑起舞	po'suo'qi'wu	1
破涕为笑	po'ti'wei'xiao	1
泼天大祸	po'tian'da'huo	1
破桐之叶	po'tong'zhi'ye	1
破颜微笑	po'yan'wei'xiao	1
泼油救火	po'you'jiu'huo	1
迫在眉睫	po'zai'mei'jie	1
破绽百出	po'zhan'bai'chu	1
破竹之势	po'zhu'zhi'shi	1
裒多益寡	pou'duo'yi'gua	1
剖腹藏珠	pou'fu'cang'zhu	1
剖肝泣血	pou'gan'qi'xue	1
剖决如流	pou'jue'ru'liu	1
蒲鞭之罚	pu'bian'zhi'fa	1
普度众生	pu'du'zhong'sheng	1
铺锦列绣	pu'jin'lie'xiu	1
蒲柳之姿	pu'liu'zhi'zi	1
铺眉蒙眼	pu'mei'meng'yan	1
仆仆风尘	pu'pu'feng'chen	1
菩萨低眉	pu'sa'di'mei	1
暴腮龙门	pu'sai'long'men	1
扑杀此獠	pu'sha'ci'lao	1
扑朔迷离	pu'shuo'mi'li	1
铺天盖地	pu'tian'gai'di	1
普天率土	pu'tian'shuai'tu	1
普天同庆	pu'tian'tong'qing	1
璞玉浑金	pu'yu'hun'jin	1
铺张浪费	pu'zhang'lang'fei	1
铺张扬厉	pu'zhang'yang'li	1
乞哀告怜	qi'ai'gao'lian	1
弃暗投明	qi'an'tou'ming	1
泣不成声	qi'bu'cheng'sheng	1
七步之才	qi'bu'zhi'cai	1
七长八短	qi'chang'ba'duan	1
起承转合	qi'cheng'zhuan'he	1
奇耻大辱	qi'chi'da'ru	1
气冲牛斗	qi'chong'niu'dou	1
气冲霄汉	qi'chong'xiao'han	1
气喘吁吁	qi'chuan'xu'xu	1
砌词捏控	qi'ci'nie'kong	1
齐大非耦	qi'da'fei'ou	1
欺大压小	qi'da'ya'xiao	1
七颠八倒	qi'dian'ba'dao	1
齐东野语	qi'dong'ye'yu	1
器二不匮	qi'er'bu'kui	1
乞儿乘车	qi'er'cheng'che	1
妻儿老小	qi'er'lao'xiao	1
乞儿马医	qi'er'ma'yi	1
棋逢对手	qi'feng'dui'shou	1
凄风苦雨	qi'feng'ku'yu	1
起凤腾蛟	qi'feng'teng'jiao	1
七高八低	qi'gao'ba'di	1
起根发由	qi'gen'fa'you	1
欺公罔法	qi'gong'wang'fa	1
旗鼓相当	qi'gu'xiang'dang	1
气贯长虹	qi'guan'chang'hong	1
奇光异彩	qi'guang'yi'cai	1
七行俱下	qi'hang'ju'xia	1
漆黑一团	qi'hei'yi'tuan	1
骑虎难下	qi'hu'nan'xia	1
琪花瑶草	qi'hua'yao'cao	1
奇花异草	qi'hua'yi'cao	1
奇货可居	qi'huo'ke'ju	1
气急败坏	qi'ji'bai'huai	1
骐骥过隙	qi'ji'guo'xi	1
奇技淫巧	qi'ji'yin'qiao	1
弃甲丢盔	qi'jia'diu'kui	1
弃甲曳兵	qi'jia'ye'bing	1
齐家治国	qi'jia'zhi'guo	1
乞浆得酒	qi'jiang'de'jiu	1
弃旧怜新	qi'jiu'lian'xin	1
弃旧图新	qi'jiu'tu'xin	1
欺君罔上	qi'jun'wang'shang	1
欺君误国	qi'jun'wu'guo	1
旗开得胜	qi'kai'de'sheng	1
其乐无穷	qi'le'wu'qiong	1
七棱八瓣	qi'leng'ba'ban	1
妻离子散	qi'li'zi'san	1
七零八落	qi'ling'ba'luo	1
歧路亡羊	qi'lu'wang'yang	1
骑驴觅驴	qi'lv'mi'lv	1
骑马找马	qi'ma'zhao'ma	1
其貌不扬	qi'mao'bu'yang	1
七扭八歪	qi'niu'ba'wai	1
奇葩异卉	qi'pa'yi'hui	1
七拼八凑	qi'pin'ba'cou	1
期期艾艾	qi'qi'ai'ai	1
戚戚具尔	qi'qi'ju'er	1
七窍生烟	qi'qiao'sheng'yan	1
七擒七纵	qi'qin'qi'zong	1
七青八黄	qi'qing'ba'huang	1
七情六欲	qi'qing'liu'yu	1
欺人太甚	qi'ren'tai'shen	1
杞人忧天	qi'ren'you'tian	1
欺人之谈	qi'ren'zhi'tan	1
七日来复	qi'ri'lai'fu	1
凄入肝脾	qi'ru'gan'pi	1
欺软怕硬	qi'ruan'pa'ying	1
契若金兰	qi'ruo'jin'lan	1
欺三瞒四	qi'san'man'si	1
琴瑟之好	qi'se'zhi'hao	1
欺善怕恶	qi'shan'pa'e	1
七上八下	qi'shang'ba'xia	1
欺上瞒下	qi'shang'man'xia	1
欺上罔下	qi'shang'wang'xia	1
漆身吞炭	qi'shen'tun'tan	1
七事八事	qi'shi'ba'shi	1
欺世盗名	qi'shi'dao'ming	1
七十二行	qi'shi'er'hang	1
气势磅礴	qi'shi'pang'bo	1
其势汹汹	qi'shi'xiong'xiong	1
气势汹汹	qi'shi'xiong'xiong	1
七手八脚	qi'shou'ba'jiao	1
弃书捐剑	qi'shu'juan'jian	1
七死八活	qi'si'ba'huo	1
起死回生	qi'si'hui'sheng	1
杞宋无征	qi'song'wu'zheng	1
奇谈怪论	qi'tan'guai'lun	1
欺天诳地	qi'tian'kuang'di	1
七推八阻	qi'tui'ba'zu	1
气吞山河	qi'tun'shan'he	1
绮纨之岁	qi'wan'zhi'sui	1
其味无穷	qi'wei'wu'qiong	1
气味相投	qi'wei'xiang'tou	1
奇文共赏	qi'wen'gong'shang	1
奇文瑰句	qi'wen'gui'ju	1
气息奄奄	qi'xi'yan'yan	1
弃瑕录用	qi'xia'lu'yong	1
泣下如雨	qi'xia'ru'yu	1
泣下沾襟	qi'xia'zhan'jin	1
气象万千	qi'xiang'wan'qian	1
器小易盈	qi'xiao'yi'ying	1
弃邪归正	qi'xie'gui'zheng	1
齐心合力	qi'xin'he'li	1
齐心协力	qi'xin'xie'li	1
奇形怪状	qi'xing'guai'zhuang	1
齐烟九点	qi'yan'jiu'dian	1
气焰熏天	qi'yan'xun'tian	1
期颐之寿	qi'yi'zhi'shou	1
其应若响	qi'ying'ruo'xiang	1
气涌如山	qi'yong'ru'shan	1
岂有此理	qi'you'ci'li	1
器宇轩昂	qi'yu'xuan'ang	1
气宇轩昂	qi'yu'xuan'ang	1
起早贪黑	qi'zao'tan'hei	1
七折八扣	qi'zhe'ba'kou	1
骑者善堕	qi'zhe'shan'duo	1
奇珍异宝	qi'zhen'yi'bao	1
弃之可惜	qi'zhi'ke'xi	1
旗帜鲜明	qi'zhi'xian'ming	1
气壮山河	qi'zhuang'shan'he	1
奇装异服	qi'zhuang'yi'fu	1
七嘴八舌	qi'zui'ba'she	1
恰到好处	qia'dao'hao'chu	1
掐尖落钞	qia'jian'luo'chao	1
恰如其分	qia'ru'qi'fen	1
掐头去尾	qia'tou'qu'wei	1
千变万化	qian'bian'wan'hua	1
千变万状	qian'bian'wan'zhuang	1
千仓万箱	qian'cang'wan'xiang	1
千差万别	qian'cha'wan'bie	1
牵肠挂肚	qian'chang'gua'du	1
浅尝辄止	qian'chang'zhe'zhi	1
前车之鉴	qian'che'zhi'jian	1
前程万里	qian'cheng'wan'li	1
千疮百孔	qian'chuang'bai'kong	1
千锤百炼	qian'chui'bai'lian	1
千刀万剐	qian'dao'wan'gua	1
铅刀一割	qian'dao'yi'ge	1
千叮万嘱	qian'ding'wan'zhu	1
前度刘郎	qian'du'liu'lang	1
千端万绪	qian'duan'wan'xu	1
千恩万谢	qian'en'wan'xie	1
千方百计	qian'fang'bai'ji	1
前赴后继	qian'fu'hou'ji	1
前覆后戒	qian'fu'hou'jie	1
前俯后仰	qian'fu'hou'yang	1
千夫所指	qian'fu'suo'zhi	1
前歌后舞	qian'ge'hou'wu	1
前功尽弃	qian'gong'jin'qi	1
谦恭下士	qian'gong'xia'shi	1
前古未有	qian'gu'wei'you	1
前呼后拥	qian'hu'hou'yong	1
千呼万唤	qian'hu'wan'huan	1
千回百折	qian'hui'bai'zhe	1
千回万转	qian'hui'wan'zhuan	1
浅见寡闻	qian'jian'gua'wen	1
千娇百媚	qian'jiao'bai'mei	1
千金弊帚	qian'jin'bi'zhou	1
千金买笑	qian'jin'mai'xiao	1
千金市骨	qian'jin'shi'gu	1
千金一掷	qian'jin'yi'zhi	1
千金之子	qian'jin'zhi'zi	1
前倨后恭	qian'ju'hou'gong	1
千军万马	qian'jun'wan'ma	1
千钧一发	qian'jun'yi'fa	1
千钧重负	qian'jun'zhong'fu	1
迁客骚人	qian'ke'sao'ren	1
钱可通神	qian'ke'tong'shen	1
钳口不言	qian'kou'bu'yan	1
钳口结舌	qian'kou'jie'she	1
千里莼羹	qian'li'chun'geng	1
千里迢迢	qian'li'tiao'tiao	1
千里同风	qian'li'tong'feng	1
千里一曲	qian'li'yi'qu	1
千里犹面	qian'li'you'mian	1
千里之足	qian'li'zhi'zu	1
千了百当	qian'liao'bai'dang	1
牵萝补屋	qian'luo'bu'wu	1
黔驴技穷	qian'lv'ji'qiong	1
千虑一得	qian'lv'yi'de	1
千虑一失	qian'lv'yi'shi	1
黔驴之计	qian'lv'zhi'ji	1
千门万户	qian'men'wan'hu	1
前目后凡	qian'mu'hou'fan	1
牵牛下井	qian'niu'xia'jing	1
迁怒于人	qian'nu'yu'ren	1
倩女离魂	qian'nv'li'hun	1
千篇一律	qian'pian'yi'lv	1
前仆后继	qian'pu'hou'ji	1
千奇百怪	qian'qi'bai'guai	1
搴旗斩将	qian'qi'zhan'jiang	1
谦谦君子	qian'qian'jun'zi	1
千千万万	qian'qian'wan'wan	1
牵强附会	qian'qiang'fu'hui	1
千秋万代	qian'qiu'wan'dai	1
千秋万岁	qian'qiu'wan'sui	1
谦让未遑	qian'rang'wei'huang	1
千人所指	qian'ren'suo'zhi	1
千仞无枝	qian'ren'wu'zhi	1
倩人捉刀	qian'ren'zhuo'dao	1
千山万壑	qian'shan'wan'he	1
千山万水	qian'shan'wan'shui	1
前思后想	qian'si'hou'xiang	1
迁思回虑	qian'si'hui'lv	1
千丝万缕	qian'si'wan'lv	1
前所未闻	qian'suo'wei'wen	1
前所未有	qian'suo'wei'you	1
前庭悬鱼	qian'ting'xuan'yu	1
千头万绪	qian'tou'wan'xu	1
黔突暖席	qian'tu'nuan'xi	1
前挽后推	qian'wan'hou'tui	1
千万买邻	qian'wan'mai'lin	1
前无古人	qian'wu'gu'ren	1
千辛万苦	qian'xin'wan'ku	1
谦虚谨慎	qian'xu'jin'shen	1
千岩竞秀	qian'yan'jing'xiu	1
千岩万壑	qian'yan'wan'he	1
千言万语	qian'yan'wan'yu	1
牵羊担酒	qian'yang'dan'jiu	1
前仰后合	qian'yang'hou'he	1
潜移默化	qian'yi'mo'hua	1
前因后果	qian'yin'hou'guo	1
千载难逢	qian'zai'nan'feng	1
千载一时	qian'zai'yi'shi	1
浅斟低唱	qian'zhen'di'chang	1
千真万确	qian'zhen'wan'que	1
谦尊而光	qian'zun'er'guang	1
强本节用	qiang'ben'jie'yong	1
将伯之呼	qiang'bo'zhi'hu	1
将伯之助	qiang'bo'zhi'zhu	1
强词夺理	qiang'ci'duo'li	1
强而后可	qiang'er'hou'ke	1
强干弱枝	qiang'gan'ruo'zhi	1
强弓劲弩	qiang'gong'jin'nu	1
强聒不舍	qiang'guo'bu'she	1
强奸民意	qiang'jian'min'yi	1
枪林弹雨	qiang'lin'dan'yu	1
强弩之末	qiang'nu'zhi'mo	1
强人所难	qiang'ren'suo'nan	1
强死强活	qiang'si'qiang'huo	1
墙头马上	qiang'tou'ma'shang	1
羌无故实	qiang'wu'gu'shi	1
强颜欢笑	qiang'yan'huan'xiao	1
强作解人	qiang'zuo'jie'ren	1
敲冰求火	qiao'bing'qiu'huo	1
巧不可阶	qiao'bu'ke'jie	1
巧夺天工	qiao'duo'tian'gong	1
巧发奇中	qiao'fa'qi'zhong	1
敲骨吸髓	qiao'gu'xi'sui	1
敲金击石	qiao'jin'ji'shi	1
巧立名目	qiao'li'ming'mu	1
乔龙画虎	qiao'long'hua'hu	1
乔迁之喜	qiao'qian'zhi'xi	1
巧取豪夺	qiao'qu'hao'duo	1
巧舌如簧	qiao'she'ru'huang	1
樵苏不爨	qiao'su'bu'cuan	1
巧同造化	qiao'tong'zao'hua	1
巧伪趋利	qiao'wei'qu'li	1
巧言令色	qiao'yan'ling'se	1
巧言偏辞	qiao'yan'pian'ci	1
巧言如簧	qiao'yan'ru'huang	1
敲诈勒索	qiao'zha'le'suo	1
乔装打扮	qiao'zhuang'da'ban	1
翘足而待	qiao'zu'er'dai	1
翘足引领	qiao'zu'yin'ling	1
切齿腐心	qie'chi'fu'xin	1
切齿痛恨	qie'chi'tong'hen	1
切磋琢磨	qie'cuo'zhuo'mo	1
锲而不舍	qie'er'bu'she	1
怯防勇战	qie'fang'yong'zhan	1
切肤之痛	qie'fu'zhi'tong	1
窃钩窃国	qie'gou'qie'guo	1
切骨之仇	qie'gu'zhi'chou	1
窃据要津	qie'ju'yao'jin	1
挈瓶之知	qie'ping'zhi'zhi	1
切切此布	qie'qie'ci'buo	1
窃窃私议	qie'qie'si'yi	1
切切私语	qie'qie'si'yu	1
窃窃私语	qie'qie'si'yu	1
怯声怯气	qie'sheng'qie'qi	1
切树倒根	qie'shu'dao'gen	1
窃位素餐	qie'wei'su'can	1
惬心贵当	qie'xin'gui'dang	1
窃玉偷香	qie'yu'tou'xiang	1
切中时弊	qie'zhong'shi'bi	1
且住为佳	qie'zhu'wei'jia	1
寝不安席	qin'bu'an'xi	1
钦差大臣	qin'chai'da'chen	1
琴断朱弦	qin'duan'zhu'xian	1
琴剑飘零	qin'jian'piao'ling	1
秦晋之好	qin'jin'zhi'hao	1
秦镜高悬	qin'jing'gao'xuan	1
禽困覆车	qin'kun'fu'che	1
秦楼楚馆	qin'lou'chu'guan	1
亲密无间	qin'mi'wu'jian	1
勤能补拙	qin'neng'bu'zhuo	1
沁人心脾	qin'ren'xin'pi	1
亲如骨肉	qin'ru'gu'rou	1
亲如手足	qin'ru'shou'zu	1
琴瑟调和	qin'se'tiao'he	1
寝苫枕块	qin'shan'zhen'kuai	1
寝食不安	qin'shi'bu'an	1
螓首蛾眉	qin'shou'er'mei	1
秦庭之哭	qin'ting'zhi'ku	1
亲痛仇快	qin'tong'chou'kuai	1
禽息鸟视	qin'xi'niao'shi	1
琴心剑胆	qin'xin'jian'dan	1
勤学苦练	qin'xue'ku'zh	1
衾影无惭	qin'ying'wu'can	1
秦越肥瘠	qin'yue'fei'ji	1
情不可却	qing'bu'ke'que	1
情不自禁	qing'bu'zi'jin	1
倾肠倒肚	qing'chang'dao'du	1
倾巢出动	qing'chao'chu'dong	1
倾巢而出	qing'chao'er'chu	1
轻车简从	qing'che'jian'cong	1
轻车熟路	qing'che'shu'lu	1
清尘浊水	qing'chen'zhuo'shui	1
倾城倾国	qing'cheng'qing'guo	1
青出于蓝	qing'chu'yu'lan	1
庆吊不行	qing'diao'bu'xing	1
情窦初开	qing'dou'chu'kai	1
倾耳而听	qing'er'er'ting	1
轻而易举	qing'er'yi'ju	1
倾耳注目	qing'er'zhu'mu	1
清风峻节	qing'feng'jun'jie	1
清风两袖	qing'feng'liang'xiu	1
清风明月	qing'feng'ming'yue	1
轻歌曼舞	qing'ge'man'wu	1
清宫除道	qing'gong'chu'dao	1
清规戒律	qing'gui'jie'lv	1
倾国倾城	qing'guo'qing'cheng	1
青红皂白	qing'hong'zao'bai	1
青黄不接	qing'huang'bu'jie	1
情急智生	qing'ji'sheng'zhi	1
倾家荡产	qing'jia'dang'chan	1
情见乎辞	qing'jian'hu'ci	1
情景交融	qing'jing'jiao'rong	1
清净无为	qing'jing'wu'wei	1
轻举妄动	qing'ju'wang'dong	1
轻举远游	qing'ju'yuan'you	1
请君入瓮	qing'jung'ru'weng	1
青林黑塞	qing'lin'hei'sai	1
轻虑浅谋	qing'lv'qian'mou	1
青梅竹马	qing'mei'zhu'ma	1
青面獠牙	qing'mian'liao'ya	1
轻描淡写	qing'miao'dan'xie	1
轻诺寡信	qing'nuo'gua'xin	1
倾盆大雨	qing'pen'da'yu	1
青钱万选	qing'qian'wan'xuan	1
卿卿我我	qing'qing'wo'wo	1
轻裘肥马	qing'qiu'fei'ma	1
轻裘缓带	qing'qiu'huan'dai	1
青山不老	qing'shan'bu'lao	1
青山绿水	qing'shan'lv'shui	1
青山一发	qing'shan'yi'fa	1
情深潭水	qing'shen'tan'shui	1
轻视傲物	qing'shi'ao'wu	1
青史传名	qing'shi'chuan'ming	1
轻手轻脚	qing'shou'qing'jiao	1
情恕理遣	qing'shu'li'qian	1
情随事迁	qing'sui'shi'qian	1
清汤寡水	qing'tang'gua'shui	1
青天白日	qing'tian'bai'ri	1
情天孽海	qing'tian'nie'hai	1
晴天霹雳	qing'tian'pi'li	1
青天霹雳	qing'tian'pi'li	1
蜻蜓点水	qing'ting'dian'shui	1
情同骨肉	qing'tong'gu'rou	1
情同手足	qing'tong'shou'zu	1
情投意合	qing'tou'yi'he	1
情见乎辞	qing'xian'hu'ci	1
情见势屈	qing'xian'shi'qu	1
倾箱倒箧	qing'xiang'dao'qie	1
青鞋布袜	qing'xie'bu'wa	1
清心寡欲	qing'xin'gua'yu	1
清新俊逸	qing'xin'jun'yi	1
倾心吐胆	qing'xin'tu'dan	1
倾摇懈弛	qing'yao'xie'chi	1
清夜扪心	qing'ye'men'xin	1
清音幽韵	qing'yin'you'yun	1
青蝇点素	qing'ying'dian'su	1
青蝇吊客	qing'ying'diao'ke	1
情有可原	qing'you'ke'yuan	1
轻于鸿毛	qing'yu'hong'mao	1
青云直上	qing'yun'zhi'shang	1
情至意尽	qing'zhi'yi'jin	1
轻重倒置	qing'zhong'dao'zhi	1
轻重缓急	qing'zhong'huan'ji	1
青州从事	qing'zhou'cong'shi	1
磬竹难书	qing'zhu'nan'shu	1
轻装上阵	qing'zhuang'shang'zhen	1
青紫被体	qing'zi'pi'ti	1
请自隗始	qing'zi'wei'shi	1
轻嘴薄舌	qing'zui'bo'she	1
穷兵黩武	qiong'bing'du'wu	1
穷不失义	qiong'bu'shi'yi	1
琼厨金穴	qiong'chu'jin'xue	1
穷大失居	qiong'da'shi'ju	1
穷当益坚	qiong'dang'yi'jian	1
穷而后工	qiong'er'hou'gong	1
穷极思变	qiong'ji'si'bian	1
穷极无聊	qiong'ji'wu'liao	1
琼浆玉液	qiong'jiang'yu'ye	1
穷寇勿追	qiong'kou'wu'zhui	1
穷困潦倒	qiong'kun'liao'dao	1
穷理尽性	qiong'li'jin'xing	1
琼林玉树	qiong'lin'yu'shu	1
琼楼玉宇	qiong'lou'yu'yu	1
穷年累月	qiong'nian'lei'yue	1
穷鸟入怀	qiong'niao'ru'huai	1
穷泉朽壤	qiong'quan'xiu'rang	1
跫然足音	qiong'ran'zu'yin	1
穷山恶水	qiong'shan'e'shui	1
穷奢极侈	qiong'she'ji'chi	1
穷奢极欲	qiong'she'ji'yu	1
穷鼠啮狸	qiong'shu'nie'li	1
穷途末路	qiong'tu'mo'lu	1
穷途之哭	qiong'tu'zhi'ku	1
穷巷陋室	qiong'xiang'lou'shi	1
穷乡僻壤	qiong'xiang'pi'rang	1
穷形尽相	qiong'xing'ji'xiang	1
穷凶极恶	qiong'xiong'ji'e	1
穷阎漏屋	qiong'yan'lou'wu	1
穷猿奔林	qiong'yuan'ben'lin	1
穷源竟委	qiong'yuan'jing'wei	1
穷源朔流	qiong'yuan'shuo'liu	1
穷猿投林	qiong'yuan'tou'lin	1
穷则思变	qiong'ze'si'bian	1
琼枝玉叶	qiong'zhi'yu'ye	1
裘弊金尽	qiu'bi'jin'jin	1
秋风过耳	qiu'feng'guo'er	1
秋风团扇	qiu'feng'tuan'shan	1
秋高气爽	qiu'gao'qi'shuang	1
秋毫无犯	qiu'hao'wu'fan	1
秋毫之末	qiu'hao'zhi'mo	1
求浆得酒	qiu'jiang'de'jiu	1
裘马轻肥	qiu'ma'qing'fei	1
求马唐肆	qiu'ma'tang'si	1
求亲靠友	qiu'qin'kao'you	1
求全责备	qiu'quan'ze'bei	1
求全之毁	qiu'quan'zhi'hui	1
求仁得仁	qiu'ren'de'ren	1
秋色平分	qiu'se'ping'fen	1
秋扇见捐	qiu'shan'jian'juan	1
丘山之功	qiu'shan'zhi'gong	1
求神问卜	qiu'shen'wen'bu	1
囚首垢面	qiu'shou'gou'mian	1
秋水伊人	qiu'shui'yi'ren	1
求田问舍	qiu'tian'wen'she	1
求同存异	qiu'tong'cun'yi	1
秋荼密网	qiu'tu'mi'wang	1
求贤若渴	qiu'xian'ruo'ke	1
秋月春风	qiu'yue'chun'feng	1
秋月春花	qiu'yue'chun'hua	1
求之不得	qiu'zhi'bu'de	1
祛病延年	qu'bing'yan'nian	1
取长补短	qu'chang'bu'duan	1
去粗取精	qu'cu'qu'jing	1
屈打成招	qu'da'cheng'zhao	1
取而代之	qu'e'dai'zhi	1
曲高和寡	qu'gao'he'gua	1
屈高就下	qu'gao'jiu'xia	1
屈蠖求伸	qu'huo'qiu'shen	1
屈节辱命	qu'jie'ru'ming	1
曲尽其妙	qu'jin'qi'miao	1
曲径通幽	qu'jing'tong'you	1
取精用弘	qu'jing'yong'hong	1
曲里拐弯	qu'li'guan'wan	1
去末归本	qu'mo'gui'ben	1
取巧图便	qu'qiao'tu'bian	1
区区之众	qu'qu'zhi'zhong	1
去泰去甚	qu'tai'qu'shen	1
曲突徙薪	qu'tu'xi'xin	1
去伪存真	qu'wei'cun'zhen	1
区闻陬见	qu'wen'zou'jian	1
取辖投井	qu'xia'tou'jing	1
取信于民	qu'xin'yu'min	1
屈艳班香	qu'yan'ban'xiang	1
趋炎附势	qu'yan'fu'shi	1
驱羊攻虎	qu'yang'gong'hu	1
曲意逢迎	qu'yi'feng'ying	1
取予有节	qu'yu'you'jie	1
屈指可数	qu'zhi'ke'shu	1
趋之若鹜	qu'zhi'ruo'wu	1
曲终奏雅	qu'zhong'zou'ya	1
去住两难	qu'zhu'liang'nan	1
劝百讽一	quan'bai'feng'yi	1
拳打脚踢	quan'da'jiao'ti	1
犬吠之警	quan'fei'zhi'jing	1
全功尽弃	quan'gong'jin'qi	1
权衡轻重	quan'heng'qing'zhong	1
全军覆灭	quan'jun'fu'mie	1
全军覆没	quan'jun'fu'mo	1
全力以赴	quan'li'yi'fu	1
犬马之报	quan'ma'zhi'bao	1
犬马之劳	quan'ma'zhi'lao	1
犬马之养	quan'ma'zhi'yang	1
拳拳服膺	quan'quan'fu'ying	1
拳拳之枕	quan'quan'zhi'zhen	1
劝善惩恶	quan'shan'cheng'e	1
全神贯注	quan'shen'guan'zhu	1
泉石膏肓	quan'shi'gao'huang	1
全始全终	quan'shi'quan'zhong	1
全受全归	quan'shou'quan'gui	1
犬兔俱毙	quan'tu'ju'bi	1
全无心肝	quan'wu'xin'gan	1
全心全意	quan'xin'quan'yi	1
犬牙交错	quan'ya'jiao'cuo	1
犬牙相错	quan'ya'xiang'cuo	1
犬牙相制	quan'ya'xiang'zhi	1
权宜之计	quan'yi'zhi'ji	1
全智全能	quan'zhi'quan'neng	1
全知全能	quan'zhi'quan'neng	1
拳中掿沙	quan'zhong'nuo'sha	1
鹊巢鸠占	que'chao'jiu'zhan	1
确乎不拔	que'hu'bu'ba	1
雀屏中选	que'ping'zhong'xuan	1
确切不移	que'qie'bu'yi	1
雀鼠之争	que'shu'zhi'zheng	1
鹊笑鸠舞	que'xiao'jiu'wu	1
雀小脏全	que'xiao'zang'quan	1
确凿不移	que'zao'bu'yi	1
却之不恭	que'zhi'bu'gong	1
群策群力	qun'ce'qun'li	1
群雌粥粥	qun'ci'yu'yu	1
裙带关系	qun'dai'guan'xi	1
群而不党	qun'er'bu'dang	1
群鸿戏海	qun'hong'xi'hai	1
裙屐少年	qun'ji'shao'nian	1
群空冀北	qun'kong'ji'bei	1
群龙无首	qun'long'wu'shou	1
群魔乱舞	qun'mo'luan'wu	1
群起效尤	qun'qi'xiao'you	1
群情鼎沸	qun'qing'ding'fei	1
群轻折轴	qun'qing'zhe'zhou	1
群威群胆	qun'wei'qun'dan	1
群蚁附膻	qun'yi'fu'shan	1
染苍染黄	ran'cang'ran'huang	1
然荻读书	ran'di'du'shu	1
燃糠自照	ran'kang'zi'zhao	1
燃眉之急	ran'mei'zhi'ji	1
攘来熙往	rang'lai'xi'wang	1
穰穰满家	rang'rang'man'jia	1
让枣推梨	rang'zao'tui'li	1
饶有风趣	rao'you'feng'qu	1
热熬翻饼	re'ao'fan'bing	1
惹草拈花	re'cao'nian'hua	1
热火朝天	re'huo'chao'tian	1
惹火烧身	re'huo'shao'shen	1
热泪盈眶	re'lei'ying'kuang	1
惹事生非	re'shi'sheng'fei	1
热血沸腾	re'xue'fei'teng	1
人百其身	ren'bai'qi'shen	1
人才辈出	ren'cai'bei'chu	1
人才济济	ren'cai'ji'ji	1
人财两空	ren'cai'liang'kong	1
人存政举	ren'cun'zheng'ju	1
人地生疏	ren'di'sheng'shu	1
人定胜天	ren'ding'sheng'tian	1
人多势众	ren'duo'shi'zhong	1
人多手杂	ren'duo'shou'za	1
人多嘴杂	ren'duo'zui'za	1
人非木石	ren'fei'mu'shi	1
人浮于事	ren'fu'yu'shi	1
人欢马叫	ren'huan'ma'jiao	1
人给家足	ren'ji'jia'zu	1
人己一视	ren'ji'yi'shi	1
人急智生	ren'ji'zhi'sheng	1
人间地狱	ren'jian'di'yu	1
仁浆义粟	ren'jiang'yi'su	1
人杰地灵	ren'jie'di'ling	1
人尽其才	ren'jin'qi'cai	1
忍俊不禁	ren'jun'bu'jin	1
人困马乏	ren'kun'ma'fa	1
任达不拘	ren'lao'bu'ju	1
任劳任怨	ren'lao'ren'yuan	1
人老珠黄	ren'lao'zhu'huang	1
人面兽心	ren'mian'shou'xin	1
人面桃花	ren'mian'tao'hua	1
人民城郭	ren'min'cheng'guo	1
人命关天	ren'ming'guan'tian	1
人命危浅	ren'ming'wei'qian	1
人莫予毒	ren'mo'yu'du	1
认奴作郞	ren'nu'zuo'lang	1
忍气吞声	ren'qi'tun'sheng	1
人弃我取	ren'qi'wo'qu	1
任其自流	ren'qi'zi'liu	1
任其自然	ren'qi'zi'ran	1
人强马壮	ren'qiang'ma'zhuang	1
人琴俱亡	ren'qin'ju'wang	1
人情冷暖	ren'qing'leng'nuan	1
人情世故	ren'qing'shi'gu	1
人穷志短	ren'qiong'zhi'duan	1
人穷智短	ren'qiong'zhi'duan	1
人去楼空	ren'qu'lou'kong	1
人取我与	ren'qu'wo'yu	1
人人皆知	ren'ren'jie'zhi	1
任人唯亲	ren'ren'wei'qin	1
任人唯贤	ren'ren'wei'xian	1
仁人志士	ren'ren'zhi'shi	1
人人自危	ren'ren'zi'wei	1
忍辱负重	ren'ru'fu'zhong	1
忍辱含垢	ren'ru'han'gou	1
忍辱含羞	ren'ru'han'xiu	1
忍辱偷生	ren'ru'tou'sheng	1
人山人海	ren'shan'ren'hai	1
人神共愤	ren'shen'gong'fen	1
人声鼎沸	ren'sheng'ding'fei	1
人生如寄	ren'sheng'ru'ji	1
人事代谢	ren'shi'dai'xie	1
人寿年丰	ren'shou'nian'feng	1
人手一册	ren'shou'yi'ce	1
人死留名	ren'si'liu'ming	1
人头畜鸣	ren'tou'chu'ming	1
人亡物在	ren'wang'wu'zai	1
人亡政息	ren'wang'zheng'xi	1
人微权轻	ren'wei'quan'qing	1
人微言轻	ren'wei'yan'qing	1
忍无可忍	ren'wu'ke'ren	1
任贤使能	ren'xian'shi'neng	1
人心不古	ren'xin'bu'gu	1
人心归向	ren'xin'gui'xiang	1
忍心害理	ren'xin'hai'li	1
人心惶惶	ren'xin'huang'huang	1
仁心仁术	ren'xin'ren'shu	1
仁心仁闻	ren'xin'ren'wen	1
人心如面	ren'xin'ru'mian	1
人心所向	ren'xin'suo'xiang	1
人心惟危	ren'xin'wei'wei	1
人心向背	ren'xin'xiang'bei	1
人烟稠密	ren'yan'chou'mi	1
人言藉藉	ren'yan'ji'ji	1
人言可畏	ren'yan'ke'wei	1
仁言利博	ren'yan'li'bo	1
人言啧啧	ren'yan'ze'ze	1
人仰马翻	ren'yang'ma'fan	1
仁义道德	ren'yi'dao'de	1
人一己百	ren'yi'ji'bai	1
仁义君子	ren'yi'jun'zi	1
人以群分	ren'yi'qun'fen	1
刃迎缕解	ren'ying'lv'jie	1
忍尤含垢	ren'you'han'gou	1
人欲横流	ren'yu'heng'liu	1
人云亦云	ren'yun'yi'yun	1
认贼为子	ren'zei'wei'zi	1
认贼作父	ren'zei'zuo'fu	1
人之常情	ren'zhi'chang'qing	1
仁至义尽	ren'zhi'yi'jin	1
任重才轻	ren'zhong'cai'qing	1
任重道远	ren'zhong'dao'yuan	1
人中骐骥	ren'zhong'qi'ji	1
人众胜天	ren'zhong'sheng'tian	1
人中狮子	ren'zhong'shi'zi	1
人中之龙	ren'zhong'zhi'long	1
任重至远	ren'zhong'zhi'yuan	1
人自为战	ren'zi'wei'zhan	1
日薄西山	ri'bo'xi'shan	1
日不暇给	ri'bu'xia'ji	1
日不移晷	ri'bu'yi'gui	1
日长一线	ri'chang'yi'xian	1
日东月西	ri'dong'yue'xi	1
日复一日	ri'fu'yi'ri	1
日旰忘餐	ri'gan'wang'can	1
日积月累	ri'ji'yue'lei	1
日居月诸	ri'ji'yue'zh	1
日久天长	ri'jiu'tian'chang	1
日就月将	ri'jiu'yue'jiang	1
日理万机	ri'li'wan'ji	1
日暮途穷	ri'mu'tu'qiong	1
日暮途远	ri'mu'tu'yuan	1
日上三竿	ri'shang'san'gan	1
日甚一日	ri'shen'yi'ri	1
日升月恒	ri'sheng'yue'geng	1
日食万钱	ri'shi'wan'qian	1
日往月来	ri'wang'yue'lai	1
日无暇晷	ri'wu'xia'gui	1
日下无双	ri'xia'wu'shuang	1
日新月异	ri'xin'yue'yi	1
日省月试	ri'xing'yue'shi	1
日削月割	ri'xue'yue'ge	1
日削月朘	ri'xue'yue'juan	1
日以继夜	ri'yi'ji'ye	1
日月重光	ri'yue'chong'guang	1
日月蹉跎	ri'yue'cuo'tuo	1
日月合壁	ri'yue'he'bi	1
日月交食	ri'yue'jiao'shi	1
日月丽天	ri'yue'li'tian	1
日月入怀	ri'yue'ru'huai	1
日月如梭	ri'yue'ru'suo	1
日月参辰	ri'yue'shen'chen	1
日中必彗	ri'zhong'bi'hui	1
日中为市	ri'zhong'wei'shi	1
日中则昃	ri'zhong'ze'ze	1
日转千阶	ri'zhuan'qian'jie	1
日坐愁城	ri'zuo'chou'cheng	1
冗词赘句	rong'ci'zhui'ju	1
容光焕发	rong'guang'huan'fa	1
荣华富贵	rong'hua'fu'gui	1
融会贯通	rong'hui'guan'tong	1
戎马倥偬	rong'ma'kong'zong	1
容头过身	rong'tou'guo'shen	1
荣谐伉俪	rong'xie'kang'li	1
荣宗耀祖	rong'zong'yao'zu	1
肉薄骨并	rou'bo'gu'bing	1
柔肠百结	rou'chang'bai'jie	1
柔茹刚吐	rou'ru'gang'tu	1
肉山脯林	rou'shan'fu'lin	1
肉食者鄙	rou'shi'zhe'bi	1
肉袒面缚	rou'tan'mian'fu	1
肉袒牵羊	rou'tan'qian'yang	1
肉跳心惊	rou'tiao'xin'jing	1
柔心弱骨	rou'xin'ruo'gu	1
肉眼凡胎	rou'yan'fan'tai	1
肉眼惠眉	rou'yan'hui'mei	1
如臂使指	ru'bi'shi'zhi	1
入不敷出	ru'bu'fu'chu	1
如不胜衣	ru'bu'sheng'yi	1
如痴如醉	ru'chi'ru'zui	1
如出一口	ru'chu'yi'kou	1
如出一辙	ru'chu'yi'zhe	1
如此而已	ru'ci'er'yi	1
如蹈汤火	ru'dao'tang'huo	1
如登春台	ru'de'chun'tai	1
如堕烟海	ru'duo'yan'hai	1
如法炮制	ru'fa'pao'zhi	1
如风过耳	ru'feng'guo'er	1
如鲠在喉	ru'geng'zai'hou	1
入国问俗	ru'guo'wen'su	1
如虎添翼	ru'hu'tian'yi	1
如花似锦	ru'hua'si'jin	1
如花似玉	ru'hua'si'yu	1
如火燎原	ru'huo'liao'yuan	1
如火如荼	ru'huo'ru'tu	1
如获至宝	ru'huo'zhi'bao	1
如饥似渴	ru'ji'si'ke	1
如见肺肝	ru'jian'fei'gan	1
乳间股脚	ru'jian'gu'jiao	1
如箭在弦	ru'jian'zai'xian	1
如胶如漆	ru'jiao'ru'qi	1
如胶似漆	ru'jiao'si'qi	1
如解倒悬	ru'jie'dao'xuan	1
入井望天	ru'jing'wang'tian	1
入境问禁	ru'jing'wen'jin	1
茹苦含辛	ru'ku'han'xin	1
如狼牧羊	ru'lang'mu'yang	1
如狼似虎	ru'lang'si'hu	1
如雷贯耳	ru'lei'guan'er	1
如临大敌	ru'lin'da'di	1
如临深渊	ru'lin'shen'yuan	1
如履薄冰	ru'lv'bo'bing	1
如芒在背	ru'mang'zai'bei	1
茹毛饮血	ru'mao'yin'xue	1
入门问讳	ru'men'wen'hui	1
如梦初醒	ru'meng'chu'xing	1
如梦方醒	ru'meng'fang'xing	1
入木三分	ru'mu'san'fen	1
入幕之宾	ru'mu'zhi'bin	1
如鸟兽散	ru'niao'shou'san	1
如牛负重	ru'niu'fu'zhong	1
如弃敝屣	ru'qi'bi'xi	1
如泣如诉	ru'qi'ru'su	1
入情入理	ru'qing'ru'li	1
如丘而止	ru'qiu'er'zhi	1
如日方升	ru'ri'fang'sheng	1
如日方中	ru'ri'fang'zhong	1
如日中天	ru'ri'zhong'tian	1
茹柔吐刚	ru'rou'tu'gang	1
如丧考妣	ru'sang'kao'bi	1
入圣超凡	ru'sheng'chao'fan	1
入室操戈	ru'shi'cao'ge	1
如拾地芥	ru'shi'di'jie	1
如是我闻	ru'shi'wo'wen	1
如释重负	ru'shi'zhong'fu	1
如手如足	ru'shou'ru'zu	1
如水赴壑	ru'shu'fu'he	1
如数家珍	ru'shu'jia'zhen	1
如水投石	ru'shu'tou'shi	1
如汤沃雪	ru'tang'wo'xue	1
入铁主簿	ru'tie'zhu'bu	1
入吾彀中	ru'wu'gou'zhong	1
入乡随俗	ru'xiang'sui'su	1
如兄如弟	ru'xiong'ru'di	1
乳臭未干	ru'xiu'wei'gan	1
如埙如箎	ru'xun'ru'chi	1
如蚁附膻	ru'yi'fu'shan	1
如意算盘	ru'yi'suan'pan	1
如饮醍醐	ru'yin'ti'hu	1
如应斯响	ru'ying'si'xiang	1
如影随形	ru'ying'sui'xing	1
如蝇逐臭	ru'ying'zhu'chou	1
如鱼得水	ru'yu'de'shui	1
如愿以偿	ru'yuan'yi'chang	1
如运诸掌	ru'yun'zhu'zhang	1
如振落叶	ru'zhen'luo'ye	1
入主出奴	ru'zhu'chu'nu	1
如锥画沙	ru'zhui'hua'sha	1
孺子可教	ru'zi'ke'jiao	1
如醉方醒	ru'zui'fang'xing	1
如醉如痴	ru'zui'ru'chi	1
如坐春风	ru'zuo'chun'feng	1
如左右手	ru'zuo'you'shou	1
如坐云雾	ru'zuo'yun'wu	1
如坐针毡	ru'zuo'zhen'zhan	1
软红十丈	ruan'hong'shi'zhang	1
软红香土	ruan'hong'xiang'yu	1
阮囊羞涩	ruan'nang'xiu'se	1
软硬兼施	ruan'ying'jian'shi	1
软玉温香	ruan'yu'wen'xiang	1
锐不可当	rui'bu'ke'dang	1
若敖鬼馁	ruo'ao'gui'nei	1
弱不好弄	ruo'bu'hao'nong	1
弱不禁风	ruo'bu'jin'feng	1
弱不胜衣	ruo'bu'sheng'yi	1
若存若亡	ruo'cun'ruo'wang	1
若即若离	ruo'ji'ruo'li	1
若明若暗	ruo'ming'ruo'an	1
弱肉强食	ruo'rou'qiang'shi	1
弱水之隔	ruo'shui'zhi'ge	1
若无其事	ruo'wu'qi'shi	1
若隐若现	ruo'yin'ruo'xian	1
若有所失	ruo'you'suo'shi	1
若有所思	ruo'you'suo'si	1
撒娇撒痴	sa'jiao'sa'chi	1
飒爽英姿	sa'shuang'ying'zi	1
撒水拿鱼	sa'shui'na'yu	1
塞翁失马	sai'weng'shi'ma	1
三班六房	san'ban'liu'fang	1
散兵游勇	san'bing'you'yong	1
三曹对案	san'cao'dui'an	1
三差两错	san'cha'liang'cuo	1
三茶六饭	san'cha'liu'fan	1
三长两短	san'chang'liang'duan	1
三朝元老	san'chao'yuan'lao	1
三从四德	san'cong'si'de	1
三寸之舌	san'cun'zhi'she	1
三迭阳关	san'die'yang'guan	1
三对六面	san'dui'liu'mian	1
三翻四复	san'fan'si'fu	1
三番五次	san'fan'wu'ci	1
三分鼎足	san'fen'ding'zu	1
三坟五典	san'fen'wu'dian	1
三复斯言	san'fu'si'yan	1
三纲五常	san'gang'wu'chang	1
三更半夜	san'geng'ban'ye	1
三姑六婆	san'gu'liu'po	1
三顾茅庐	san'gu'mao'lu	1
三户亡秦	san'hu'wang'qin	1
三皇五帝	san'huang'wu'di	1
三魂七魄	san'hun'qi'po	1
三缄其口	san'jian'qi'kou	1
三教九流	san'jiao'jiu'liu	1
三街六巷	san'jie'liu'xiang	1
三老五更	san'lao'wu'geng	1
三令五申	san'ling'wu'shen	1
三六九等	san'liu'jiu'deng	1
三马同槽	san'ma'tong'cao	1
三媒六证	san'mei'liu'zheng	1
三命而俯	san'ming'er'fu	1
三年化碧	san'nian'hua'bi	1
三年之艾	san'nian'zhi'ai	1
三朋四友	san'peng'si'you	1
三平二满	san'ping'er'man	1
三妻四妾	san'qi'si'qie	1
三人成虎	san'ren'cheng'hu	1
三人为众	san'ren'wei'zhong	1
三三两两	san'san'liang'liang	1
三三五五	san'san'wu'wu	1
三蛇七鼠	san'she'qi'shu	1
三牲五鼎	san'sheng'wu'ding	1
三生有幸	san'sheng'you'xing	1
三尸暴跳	san'shi'bao'tiao	1
三十而立	san'shi'er'li	1
三十六行	san'shi'liu'hang	1
三十三天	san'shi'san'tian	1
三豕涉河	san'shi'she'he	1
三思而行	san'si'er'xing	1
三天两头	san'tian'liang'tou	1
三头对案	san'tou'dui'an	1
三头两面	san'tou'liang'mian	1
三头两绪	san'tou'liang'xu	1
三头六臂	san'tou'liu'bi	1
三推六问	san'tui'liu'wen	1
三瓦两舍	san'wa'liang'she	1
三位一体	san'wei'yi'ti	1
三五成群	san'wu'cheng'qun	1
三心二意	san'xin'er'yi	1
三衅三浴	san'xin'san'yu	1
三星在户	san'xing'zai'hu	1
三星在天	san'xing'zai'tian	1
三旬九食	san'xun'jiu'shi	1
三言两语	san'yan'liang'yu	1
三阳开泰	san'yang'kai'tai	1
三余读书	san'yu'du'shu	1
三浴三衅	san'yu'san'xin	1
三灾八难	san'zai'ba'nan	1
三占从二	san'zhan'cong'er	1
三战三北	san'zhan'san'bei	1
三贞九烈	san'zhen'jiu'lie	1
三智五猜	san'zhi'wu'cai	1
三纸无驴	san'zhi'wu'lv	1
三旨相公	san'zhi'xiang'gong	1
三足鼎立	san'zu'ding'li	1
桑弧蓬矢	sang'hu'peng'shi	1
丧魂落魄	sang'hun'luo'po	1
丧胆销魂	sang'hun'xiao'hun	1
丧家之犬	sang'jia'zhi'quan	1
桑间濮上	sang'jian'pu'shang	1
丧尽天良	sang'jin'tian'liang	1
桑落瓦解	sang'luo'wa'jie	1
丧明之痛	sang'ming'zhi'tong	1
丧权辱国	sang'quan'ru'guo	1
丧身失节	sang'shen'shi'jie	1
桑枢瓮牖	sang'shu'weng'you	1
桑田沧海	sang'tian'cang'hai	1
丧心病狂	sang'xin'bing'kuang	1
桑榆暮景	sang'yu'mu'jing	1
桑中之约	sang'zhong'zhi'yue	1
扫除天下	sao'chu'tian'xia	1
搔到痒处	sao'dao'yang'chu	1
扫地出门	sao'di'chu'men	1
扫地以尽	sao'di'yi'jin	1
扫眉才子	sao'mei'cai'zi	1
骚人墨客	sao'ren'mo'ke	1
扫榻以待	sao'ta'yi'dai	1
搔头摸耳	sao'tou'mo'er	1
搔头弄姿	sao'tou'nong'zi	1
色厉内荏	se'li'nei'ren	1
色仁行违	se'ren'xing'wei	1
色若死灰	se'ruo'si'hui	1
色色俱全	se'se'ju'quan	1
色授魂与	se'shou'hun'yu	1
色衰爱弛	se'shuai'ai'chi	1
涩于言论	se'yu'yan'lun	1
森罗万象	sen'luo'wan'xiang	1
森严壁垒	sen'yan'bi'lei	1
僧多粥少	seng'duo'zhou'shao	1
杀敌致果	sha'di'zhi'guo	1
煞费苦心	sha'fei'ku'xin	1
杀鸡儆猴	sha'ji'jing'hou	1
杀鸡抹脖	sha'ji'mo'bo	1
杀鸡取卵	sha'ji'qu'luan	1
杀鸡吓猴	sha'ji'xia'hou	1
沙里淘金	sha'li'tao'jin	1
杀妻求将	sha'qi'qiu'jiang	1
杀气腾腾	sha'qi'teng'teng	1
杀人如麻	sha'ren'ru'ma	1
杀人越货	sha'ren'yue'huo	1
杀身成仁	sha'shen'cheng'ren	1
歃血为盟	sha'xue'wei'meng	1
杀一儆百	sha'yi'jing'bai	1
煞有介事	sha'you'jie'shi	1
铩羽而归	sha'yu'er'gui	1
杀彘教子	sha'zhi'jiao'zi	1
筛锣擂鼓	shai'luo'lei'gu	1
山崩地裂	shan'beng'di'lie	1
山崩钟应	shan'beng'zhong'ying	1
山长水远	shan'chang'shui'yuan	1
煽风点火	shan'feng'dian'huo	1
山高水长	shan'gao'shui'chang	1
山高水低	shan'gao'shui'di	1
山光水色	shan'guang'shui'se	1
山鸡舞镜	shan'ji'wu'jing	1
山溜穿石	shan'liu'chuan'shi	1
山盟海誓	shan'meng'hai'shi	1
山明水秀	shan'ming'shui'xiu	1
山木自寇	shan'mu'zi'kou	1
山南海北	shan'nan'hai'bei	1
山栖谷隐	shan'qi'gu'yin	1
苫眼铺眉	shan'yan'pu'mei	1
扇枕温被	shan'zhen'wen'chuang	1
馈贫之粮	zuo'pin'zhi'liang	1
